,area,total,men,women,household,date
0,大阪市,2595034,1273117,1321917,1130813,1998-01-01
1,北区,87510,42012,45498,42141,1998-01-01
2,都島区,97905,48019,49886,42374,1998-01-01
3,福島区,54877,26247,28630,23699,1998-01-01
4,此花区,66638,33245,33393,27161,1998-01-01
5,中央区,53049,24481,28568,26662,1998-01-01
6,西区,59419,28354,31065,27136,1998-01-01
7,港区,88534,43977,44557,37406,1998-01-01
8,大正区,76626,38327,38299,30770,1998-01-01
9,天王寺区,56300,26255,30045,24821,1998-01-01
10,浪速区,49867,25613,24254,27781,1998-01-01
11,西淀川区,91501,45707,45794,37063,1998-01-01
12,淀川区,161219,80523,80696,75909,1998-01-01
13,東淀川区,184756,92607,92149,86452,1998-01-01
14,東成区,78375,37591,40784,33356,1998-01-01
15,生野区,146155,69835,76320,58949,1998-01-01
16,旭区,101275,48943,52332,44049,1998-01-01
17,城東区,156603,75699,80904,65938,1998-01-01
18,鶴見区,99559,49010,50549,37134,1998-01-01
19,阿倍野区,103232,48150,55082,44293,1998-01-01
20,住之江区,138315,67269,71046,53742,1998-01-01
21,住吉区,162190,77403,84787,71236,1998-01-01
22,東住吉区,140480,67161,73319,59207,1998-01-01
23,平野区,201462,97740,103722,79065,1998-01-01
24,西成区,139187,78949,60238,74469,1998-01-01
25,大阪市,2593807,1272460,1321347,1130763,1998-02-01
26,北区,87453,41993,45460,42165,1998-02-01
27,都島区,97879,48007,49872,42411,1998-02-01
28,福島区,54888,26248,28640,23719,1998-02-01
29,此花区,66528,33181,33347,27101,1998-02-01
30,中央区,52923,24426,28497,26667,1998-02-01
31,西区,59420,28351,31069,27145,1998-02-01
32,港区,88492,43949,44543,37419,1998-02-01
33,大正区,76604,38312,38292,30767,1998-02-01
34,天王寺区,56334,26277,30057,24806,1998-02-01
35,浪速区,49882,25631,24251,27787,1998-02-01
36,西淀川区,91505,45708,45797,37114,1998-02-01
37,淀川区,161055,80441,80614,75863,1998-02-01
38,東淀川区,184728,92580,92148,86442,1998-02-01
39,東成区,78395,37602,40793,33410,1998-02-01
40,生野区,145989,69753,76236,58875,1998-02-01
41,旭区,101179,48895,52284,44013,1998-02-01
42,城東区,156532,75656,80876,65951,1998-02-01
43,鶴見区,99559,49005,50554,37180,1998-02-01
44,阿倍野区,103233,48143,55090,44310,1998-02-01
45,住之江区,138301,67259,71042,53760,1998-02-01
46,住吉区,162182,77385,84797,71230,1998-02-01
47,東住吉区,140355,67095,73260,59192,1998-02-01
48,平野区,201375,97686,103689,79060,1998-02-01
49,西成区,139016,78877,60139,74376,1998-02-01
50,大阪市,2592477,1271768,1320709,1131037,1998-03-01
51,北区,87580,42063,45517,42222,1998-03-01
52,都島区,97815,47977,49838,42441,1998-03-01
53,福島区,54836,26220,28616,23715,1998-03-01
54,此花区,66449,33134,33315,27077,1998-03-01
55,中央区,52955,24444,28511,26637,1998-03-01
56,西区,59383,28330,31053,27138,1998-03-01
57,港区,88408,43900,44508,37400,1998-03-01
58,大正区,76534,38273,38261,30771,1998-03-01
59,天王寺区,56319,26275,30044,24802,1998-03-01
60,浪速区,49903,25652,24251,27906,1998-03-01
61,西淀川区,91491,45699,45792,37153,1998-03-01
62,淀川区,160969,80399,80570,75917,1998-03-01
63,東淀川区,184654,92531,92123,86477,1998-03-01
64,東成区,78340,37578,40762,33380,1998-03-01
65,生野区,145833,69675,76158,58854,1998-03-01
66,旭区,101048,48831,52217,43989,1998-03-01
67,城東区,156602,75681,80921,66046,1998-03-01
68,鶴見区,99517,48979,50538,37204,1998-03-01
69,阿倍野区,103082,48066,55016,44272,1998-03-01
70,住之江区,138153,67184,70969,53745,1998-03-01
71,住吉区,162108,77337,84771,71227,1998-03-01
72,東住吉区,140245,67035,73210,59179,1998-03-01
73,平野区,201296,97637,103659,79138,1998-03-01
74,西成区,138957,78868,60089,74347,1998-03-01
75,大阪市,2590364,1270668,1319696,1133220,1998-04-01
76,北区,88153,42347,45806,42641,1998-04-01
77,都島区,97495,47821,49674,42454,1998-04-01
78,福島区,54726,26163,28563,23770,1998-04-01
79,此花区,66276,33039,33237,27073,1998-04-01
80,中央区,53162,24543,28619,26857,1998-04-01
81,西区,59391,28331,31060,27237,1998-04-01
82,港区,88343,43861,44482,37504,1998-04-01
83,大正区,76461,38233,38228,30770,1998-04-01
84,天王寺区,56236,26242,29994,24850,1998-04-01
85,浪速区,49852,25635,24217,27935,1998-04-01
86,西淀川区,91369,45637,45732,37172,1998-04-01
87,淀川区,161040,80434,80606,76292,1998-04-01
88,東淀川区,184283,92332,91951,86601,1998-04-01
89,東成区,78444,37629,40815,33540,1998-04-01
90,生野区,145598,69559,76039,58943,1998-04-01
91,旭区,100847,48732,52115,43983,1998-04-01
92,城東区,156675,75708,80967,66312,1998-04-01
93,鶴見区,99615,49022,50593,37308,1998-04-01
94,阿倍野区,102872,47961,54911,44186,1998-04-01
95,住之江区,137850,67033,70817,53750,1998-04-01
96,住吉区,161709,77133,84576,71186,1998-04-01
97,東住吉区,140184,66998,73186,59252,1998-04-01
98,平野区,201014,97488,103526,79179,1998-04-01
99,西成区,138769,78787,59982,74425,1998-04-01
100,大阪市,2594136,1272460,1321676,1138590,1998-05-01
101,北区,88593,42567,46026,43101,1998-05-01
102,都島区,97510,47829,49681,42580,1998-05-01
103,福島区,54871,26229,28642,23916,1998-05-01
104,此花区,66385,33085,33300,27217,1998-05-01
105,中央区,53279,24600,28679,27088,1998-05-01
106,西区,59711,28480,31231,27473,1998-05-01
107,港区,88466,43915,44551,37685,1998-05-01
108,大正区,76453,38225,38228,30842,1998-05-01
109,天王寺区,56506,26374,30132,25055,1998-05-01
110,浪速区,49945,25693,24252,28091,1998-05-01
111,西淀川区,91539,45721,45818,37416,1998-05-01
112,淀川区,161428,80628,80800,76828,1998-05-01
113,東淀川区,184619,92488,92131,87001,1998-05-01
114,東成区,78555,37684,40871,33700,1998-05-01
115,生野区,145695,69603,76092,59171,1998-05-01
116,旭区,100891,48753,52138,44144,1998-05-01
117,城東区,156848,75783,81065,66591,1998-05-01
118,鶴見区,99709,49064,50645,37463,1998-05-01
119,阿倍野区,103203,48109,55094,44510,1998-05-01
120,住之江区,137840,67025,70815,53913,1998-05-01
121,住吉区,161794,77160,84634,71392,1998-05-01
122,東住吉区,140371,67081,73290,59484,1998-05-01
123,平野区,201079,97509,103570,79386,1998-05-01
124,西成区,138846,78855,59991,74543,1998-05-01
125,大阪市,2594621,1272644,1321977,1140034,1998-06-01
126,北区,88672,42614,46058,43220,1998-06-01
127,都島区,97520,47834,49686,42622,1998-06-01
128,福島区,54822,26201,28621,23904,1998-06-01
129,此花区,66330,33050,33280,27226,1998-06-01
130,中央区,53332,24628,28704,27130,1998-06-01
131,西区,59690,28467,31223,27489,1998-06-01
132,港区,88408,43880,44528,37681,1998-06-01
133,大正区,76450,38220,38230,30864,1998-06-01
134,天王寺区,56531,26392,30139,25085,1998-06-01
135,浪速区,49982,25722,24260,28161,1998-06-01
136,西淀川区,91583,45742,45841,37476,1998-06-01
137,淀川区,161546,80688,80858,77005,1998-06-01
138,東淀川区,184562,92446,92116,87105,1998-06-01
139,東成区,78568,37691,40877,33731,1998-06-01
140,生野区,145669,69587,76082,59254,1998-06-01
141,旭区,100842,48728,52114,44186,1998-06-01
142,城東区,157008,75852,81156,66700,1998-06-01
143,鶴見区,99792,49099,50693,37523,1998-06-01
144,阿倍野区,103162,48083,55079,44507,1998-06-01
145,住之江区,137798,67001,70797,53973,1998-06-01
146,住吉区,161775,77138,84637,71455,1998-06-01
147,東住吉区,140574,67171,73403,59640,1998-06-01
148,平野区,201232,97571,103661,79511,1998-06-01
149,西成区,138773,78839,59934,74586,1998-06-01
150,大阪市,2595412,1272984,1322428,1140780,1998-07-01
151,北区,88689,42630,46059,43286,1998-07-01
152,都島区,97524,47837,49687,42626,1998-07-01
153,福島区,54840,26206,28634,23920,1998-07-01
154,此花区,66327,33040,33287,27245,1998-07-01
155,中央区,53362,24645,28717,27168,1998-07-01
156,西区,59805,28518,31287,27561,1998-07-01
157,港区,88473,43905,44568,37711,1998-07-01
158,大正区,76440,38211,38229,30883,1998-07-01
159,天王寺区,56559,26410,30149,25126,1998-07-01
160,浪速区,50073,25778,24295,28217,1998-07-01
161,西淀川区,91597,45747,45850,37485,1998-07-01
162,淀川区,161665,80747,80918,77102,1998-07-01
163,東淀川区,184703,92504,92199,87179,1998-07-01
164,東成区,78585,37701,40884,33764,1998-07-01
165,生野区,145588,69545,76043,59272,1998-07-01
166,旭区,100825,48718,52107,44191,1998-07-01
167,城東区,157104,75890,81214,66749,1998-07-01
168,鶴見区,99894,49144,50750,37576,1998-07-01
169,阿倍野区,103098,48046,55052,44463,1998-07-01
170,住之江区,137791,66995,70796,53985,1998-07-01
171,住吉区,161786,77130,84656,71467,1998-07-01
172,東住吉区,140535,67145,73390,59634,1998-07-01
173,平野区,201392,97637,103755,79560,1998-07-01
174,西成区,138757,78855,59902,74610,1998-07-01
175,大阪市,2595922,1273185,1322737,1141227,1998-08-01
176,北区,88751,42669,46082,43427,1998-08-01
177,都島区,97439,47796,49643,42575,1998-08-01
178,福島区,55011,26284,28727,24069,1998-08-01
179,此花区,66294,33015,33279,27208,1998-08-01
180,中央区,53341,24638,28703,27159,1998-08-01
181,西区,59870,28546,31324,27645,1998-08-01
182,港区,88431,43877,44554,37680,1998-08-01
183,大正区,76397,38186,38211,30868,1998-08-01
184,天王寺区,56630,26449,30181,25160,1998-08-01
185,浪速区,50064,25784,24280,28226,1998-08-01
186,西淀川区,91702,45799,45903,37566,1998-08-01
187,淀川区,161618,80724,80894,77034,1998-08-01
188,東淀川区,184732,92506,92226,87129,1998-08-01
189,東成区,78659,37738,40921,33815,1998-08-01
190,生野区,145517,69508,76009,59306,1998-08-01
191,旭区,100904,48755,52149,44261,1998-08-01
192,城東区,157095,75877,81218,66750,1998-08-01
193,鶴見区,99960,49172,50788,37618,1998-08-01
194,阿倍野区,103120,48049,55071,44477,1998-08-01
195,住之江区,137737,66965,70772,53950,1998-08-01
196,住吉区,161843,77144,84699,71442,1998-08-01
197,東住吉区,140498,67120,73378,59616,1998-08-01
198,平野区,201537,97696,103841,79587,1998-08-01
199,西成区,138772,78888,59884,74659,1998-08-01
200,大阪市,2595934,1273142,1322792,1141456,1998-09-01
201,北区,88855,42728,46127,43485,1998-09-01
202,都島区,97358,47757,49601,42534,1998-09-01
203,福島区,55034,26291,28743,24096,1998-09-01
204,此花区,66218,32969,33249,27144,1998-09-01
205,中央区,53364,24652,28712,27193,1998-09-01
206,西区,59940,28576,31364,27695,1998-09-01
207,港区,88386,43848,44538,37648,1998-09-01
208,大正区,76362,38165,38197,30863,1998-09-01
209,天王寺区,56664,26471,30193,25200,1998-09-01
210,浪速区,50020,25771,24249,28245,1998-09-01
211,西淀川区,91686,45789,45897,37557,1998-09-01
212,淀川区,161658,80745,80913,77100,1998-09-01
213,東淀川区,184823,92539,92284,87144,1998-09-01
214,東成区,78650,37735,40915,33805,1998-09-01
215,生野区,145492,69493,75999,59329,1998-09-01
216,旭区,100863,48734,52129,44251,1998-09-01
217,城東区,157182,75911,81271,66850,1998-09-01
218,鶴見区,100060,49216,50844,37640,1998-09-01
219,阿倍野区,103071,48020,55051,44467,1998-09-01
220,住之江区,137701,66944,70757,53940,1998-09-01
221,住吉区,161750,77086,84664,71381,1998-09-01
222,東住吉区,140553,67139,73414,59681,1998-09-01
223,平野区,201520,97677,103843,79542,1998-09-01
224,西成区,138724,78886,59838,74666,1998-09-01
225,大阪市,2596276,1273255,1323021,1141825,1998-10-01
226,北区,88897,42757,46140,43656,1998-10-01
227,都島区,97370,47764,49606,42483,1998-10-01
228,福島区,55051,26295,28756,24126,1998-10-01
229,此花区,66153,32929,33224,27115,1998-10-01
230,中央区,53409,24676,28733,27248,1998-10-01
231,西区,60092,28645,31447,27807,1998-10-01
232,港区,88395,43846,44549,37647,1998-10-01
233,大正区,76302,38131,38171,30809,1998-10-01
234,天王寺区,56633,26462,30171,25200,1998-10-01
235,浪速区,49951,25745,24206,28252,1998-10-01
236,西淀川区,91679,45785,45894,37583,1998-10-01
237,淀川区,161594,80713,80881,77072,1998-10-01
238,東淀川区,184951,92590,92361,87199,1998-10-01
239,東成区,78700,37760,40940,33835,1998-10-01
240,生野区,145495,69491,76004,59319,1998-10-01
241,旭区,100832,48718,52114,44213,1998-10-01
242,城東区,157260,75940,81320,66885,1998-10-01
243,鶴見区,100140,49250,50890,37683,1998-10-01
244,阿倍野区,103009,47984,55025,44451,1998-10-01
245,住之江区,137676,66929,70747,53916,1998-10-01
246,住吉区,161774,77084,84690,71389,1998-10-01
247,東住吉区,140591,67150,73441,59709,1998-10-01
248,平野区,201627,97717,103910,79571,1998-10-01
249,西成区,138695,78894,59801,74657,1998-10-01
250,大阪市,2596625,1273374,1323251,1142403,1998-11-01
251,北区,88926,42779,46147,43697,1998-11-01
252,都島区,97384,47772,49612,42497,1998-11-01
253,福島区,55057,26294,28763,24155,1998-11-01
254,此花区,66168,32928,33240,27115,1998-11-01
255,中央区,53425,24686,28739,27285,1998-11-01
256,西区,60191,28689,31502,27889,1998-11-01
257,港区,88446,43864,44582,37691,1998-11-01
258,大正区,76249,38101,38148,30744,1998-11-01
259,天王寺区,56626,26465,30161,25175,1998-11-01
260,浪速区,49991,25775,24216,28317,1998-11-01
261,西淀川区,91635,45761,45874,37580,1998-11-01
262,淀川区,161601,80717,80884,77109,1998-11-01
263,東淀川区,185109,92656,92453,87277,1998-11-01
264,東成区,78675,37750,40925,33803,1998-11-01
265,生野区,145347,69417,75930,59351,1998-11-01
266,旭区,100792,48698,52094,44226,1998-11-01
267,城東区,157339,75970,81369,66942,1998-11-01
268,鶴見区,100201,49275,50926,37705,1998-11-01
269,阿倍野区,103093,48016,55077,44536,1998-11-01
270,住之江区,137652,66914,70738,53919,1998-11-01
271,住吉区,161843,77104,84739,71402,1998-11-01
272,東住吉区,140511,67105,73406,59678,1998-11-01
273,平野区,201758,97769,103989,79640,1998-11-01
274,西成区,138606,78869,59737,74670,1998-11-01
275,大阪市,2595663,1272850,1322813,1142674,1998-12-01
276,北区,88859,42756,46103,43742,1998-12-01
277,都島区,97226,47695,49531,42463,1998-12-01
278,福島区,55041,26283,28758,24183,1998-12-01
279,此花区,66079,32875,33204,27107,1998-12-01
280,中央区,53378,24668,28710,27322,1998-12-01
281,西区,60231,28704,31527,27951,1998-12-01
282,港区,88439,43854,44585,37736,1998-12-01
283,大正区,76198,38072,38126,30765,1998-12-01
284,天王寺区,56590,26454,30136,25164,1998-12-01
285,浪速区,49964,25771,24193,28345,1998-12-01
286,西淀川区,91687,45786,45901,37641,1998-12-01
287,淀川区,161533,80683,80850,77182,1998-12-01
288,東淀川区,185100,92639,92461,87354,1998-12-01
289,東成区,78651,37740,40911,33790,1998-12-01
290,生野区,145223,69355,75868,59319,1998-12-01
291,旭区,100731,48667,52064,44219,1998-12-01
292,城東区,157308,75946,81362,66973,1998-12-01
293,鶴見区,100241,49289,50952,37776,1998-12-01
294,阿倍野区,103126,48025,55101,44508,1998-12-01
295,住之江区,137610,66891,70719,53935,1998-12-01
296,住吉区,161802,77071,84731,71407,1998-12-01
297,東住吉区,140368,67029,73339,59663,1998-12-01
298,平野区,201826,97791,104035,79694,1998-12-01
299,西成区,138452,78806,59646,74435,1998-12-01
