,area,total,men,women,household,date
0,大阪市,2619736,1278731,1341005,1220219,2004-01-01
1,北区,96761,46695,50066,51926,2004-01-01
2,都島区,98904,48299,50605,45362,2004-01-01
3,福島区,58587,27810,30777,27916,2004-01-01
4,此花区,64539,31552,32987,27850,2004-01-01
5,中央区,62190,28815,33375,35891,2004-01-01
6,西区,69290,32927,36363,37626,2004-01-01
7,港区,84146,41324,42822,37726,2004-01-01
8,大正区,74020,36671,37349,31194,2004-01-01
9,天王寺区,61496,28690,32806,28992,2004-01-01
10,浪速区,52905,27210,25695,32846,2004-01-01
11,西淀川区,94870,47088,47782,40217,2004-01-01
12,淀川区,167647,83218,84429,84184,2004-01-01
13,東淀川区,180791,90136,90655,89292,2004-01-01
14,東成区,78790,37603,41187,35652,2004-01-01
15,生野区,140074,66838,73236,60863,2004-01-01
16,旭区,96872,46479,50393,43890,2004-01-01
17,城東区,159714,76584,83130,70334,2004-01-01
18,鶴見区,105782,51433,54349,41271,2004-01-01
19,阿倍野区,106050,49272,56778,46897,2004-01-01
20,住之江区,132010,63735,68275,54595,2004-01-01
21,住吉区,160256,75626,84630,73084,2004-01-01
22,東住吉区,136942,65048,71894,60591,2004-01-01
23,平野区,201344,96577,104767,82818,2004-01-01
24,西成区,135756,79101,56655,79202,2004-01-01
25,大阪市,2619306,1278401,1340905,1220535,2004-02-01
26,北区,96739,46683,50056,51960,2004-02-01
27,都島区,99060,48369,50691,45445,2004-02-01
28,福島区,58594,27811,30783,27920,2004-02-01
29,此花区,64562,31554,33008,27876,2004-02-01
30,中央区,62295,28864,33431,36045,2004-02-01
31,西区,69458,33007,36451,37785,2004-02-01
32,港区,83962,41227,42735,37677,2004-02-01
33,大正区,73975,36643,37332,31163,2004-02-01
34,天王寺区,61546,28709,32837,29010,2004-02-01
35,浪速区,52952,27227,25725,32895,2004-02-01
36,西淀川区,94869,47081,47788,40233,2004-02-01
37,淀川区,167659,83210,84449,84186,2004-02-01
38,東淀川区,180578,90028,90550,89167,2004-02-01
39,東成区,78756,37581,41175,35664,2004-02-01
40,生野区,139967,66787,73180,60890,2004-02-01
41,旭区,96804,46438,50366,43866,2004-02-01
42,城東区,159694,76566,83128,70308,2004-02-01
43,鶴見区,105888,51473,54415,41328,2004-02-01
44,阿倍野区,106040,49269,56771,46903,2004-02-01
45,住之江区,131961,63702,68259,54624,2004-02-01
46,住吉区,160158,75569,84589,73032,2004-02-01
47,東住吉区,136846,64997,71849,60538,2004-02-01
48,平野区,201282,96528,104754,82821,2004-02-01
49,西成区,135661,79078,56583,79199,2004-02-01
50,大阪市,2618916,1278084,1340832,1220884,2004-03-01
51,北区,96820,46720,50100,52053,2004-03-01
52,都島区,99062,48364,50698,45459,2004-03-01
53,福島区,58642,27832,30810,27976,2004-03-01
54,此花区,64533,31530,33003,27859,2004-03-01
55,中央区,62500,28958,33542,36129,2004-03-01
56,西区,69528,33040,36488,37916,2004-03-01
57,港区,83915,41197,42718,37673,2004-03-01
58,大正区,73977,36638,37339,31156,2004-03-01
59,天王寺区,61601,28729,32872,29048,2004-03-01
60,浪速区,52977,27232,25745,32968,2004-03-01
61,西淀川区,94841,47061,47780,40224,2004-03-01
62,淀川区,167635,83185,84450,84168,2004-03-01
63,東淀川区,180341,89908,90433,89041,2004-03-01
64,東成区,78839,37614,41225,35740,2004-03-01
65,生野区,139977,66792,73185,60961,2004-03-01
66,旭区,96701,46381,50320,43798,2004-03-01
67,城東区,159617,76520,83097,70263,2004-03-01
68,鶴見区,105901,51467,54434,41353,2004-03-01
69,阿倍野区,106105,49300,56805,46929,2004-03-01
70,住之江区,131816,63623,68193,54558,2004-03-01
71,住吉区,160121,75541,84580,72997,2004-03-01
72,東住吉区,136709,64927,71782,60501,2004-03-01
73,平野区,201162,96452,104710,82817,2004-03-01
74,西成区,135596,79073,56523,79297,2004-03-01
75,大阪市,2619623,1278297,1341326,1223794,2004-04-01
76,北区,97112,46859,50253,52365,2004-04-01
77,都島区,99098,48375,50723,45598,2004-04-01
78,福島区,58752,27882,30870,28104,2004-04-01
79,此花区,64552,31529,33023,27954,2004-04-01
80,中央区,63002,29191,33811,36469,2004-04-01
81,西区,69661,33103,36558,38130,2004-04-01
82,港区,83822,41145,42677,37710,2004-04-01
83,大正区,73937,36612,37325,31133,2004-04-01
84,天王寺区,61858,28844,33014,29259,2004-04-01
85,浪速区,53098,27286,25812,33118,2004-04-01
86,西淀川区,95160,47212,47948,40450,2004-04-01
87,淀川区,167825,83265,84560,84386,2004-04-01
88,東淀川区,180116,89794,90322,89248,2004-04-01
89,東成区,78915,37644,41271,35786,2004-04-01
90,生野区,139936,66773,73163,61038,2004-04-01
91,旭区,96482,46269,50213,43812,2004-04-01
92,城東区,159677,76540,83137,70458,2004-04-01
93,鶴見区,105973,51490,54483,41469,2004-04-01
94,阿倍野区,106224,49356,56868,47004,2004-04-01
95,住之江区,131704,63560,68144,54715,2004-04-01
96,住吉区,159809,75383,84426,73031,2004-04-01
97,東住吉区,136450,64799,71651,60386,2004-04-01
98,平野区,200973,96343,104630,82856,2004-04-01
99,西成区,135487,79043,56444,79315,2004-04-01
100,大阪市,2625046,1280801,1344245,1228415,2004-05-01
101,北区,97654,47119,50535,52759,2004-05-01
102,都島区,99356,48495,50861,45767,2004-05-01
103,福島区,59103,28047,31056,28385,2004-05-01
104,此花区,64654,31569,33085,28044,2004-05-01
105,中央区,63552,29446,34106,36913,2004-05-01
106,西区,69958,33244,36714,38466,2004-05-01
107,港区,83930,41192,42738,37804,2004-05-01
108,大正区,73965,36620,37345,31167,2004-05-01
109,天王寺区,62215,29006,33209,29503,2004-05-01
110,浪速区,53349,27407,25942,33235,2004-05-01
111,西淀川区,95444,47347,48097,40604,2004-05-01
112,淀川区,168227,83451,84776,84715,2004-05-01
113,東淀川区,180499,89983,90516,89576,2004-05-01
114,東成区,79065,37710,41355,35936,2004-05-01
115,生野区,140047,66826,73221,61181,2004-05-01
116,旭区,96545,46291,50254,43917,2004-05-01
117,城東区,159935,76655,83280,70666,2004-05-01
118,鶴見区,106022,51502,54520,41572,2004-05-01
119,阿倍野区,106539,49504,57035,47230,2004-05-01
120,住之江区,131895,63642,68253,54889,2004-05-01
121,住吉区,159965,75446,84519,73173,2004-05-01
122,東住吉区,136416,64778,71638,60479,2004-05-01
123,平野区,201220,96443,104777,83006,2004-05-01
124,西成区,135491,79078,56413,79428,2004-05-01
125,大阪市,2626322,1281299,1345023,1230032,2004-06-01
126,北区,97958,47264,50694,52980,2004-06-01
127,都島区,99430,48525,50905,45854,2004-06-01
128,福島区,59149,28067,31082,28449,2004-06-01
129,此花区,64683,31574,33109,28048,2004-06-01
130,中央区,63747,29536,34211,37067,2004-06-01
131,西区,70168,33343,36825,38675,2004-06-01
132,港区,83911,41176,42735,37785,2004-06-01
133,大正区,74025,36644,37381,31202,2004-06-01
134,天王寺区,62236,29010,33226,29544,2004-06-01
135,浪速区,53383,27417,25966,33295,2004-06-01
136,西淀川区,95636,47435,48201,40723,2004-06-01
137,淀川区,168250,83449,84801,84787,2004-06-01
138,東淀川区,180557,90010,90547,89686,2004-06-01
139,東成区,79151,37745,41406,36033,2004-06-01
140,生野区,140040,66823,73217,61208,2004-06-01
141,旭区,96560,46291,50269,43952,2004-06-01
142,城東区,159986,76671,83315,70733,2004-06-01
143,鶴見区,106130,51543,54587,41626,2004-06-01
144,阿倍野区,106566,49517,57049,47245,2004-06-01
145,住之江区,131908,63639,68269,54990,2004-06-01
146,住吉区,159897,75403,84494,73146,2004-06-01
147,東住吉区,136318,64727,71591,60444,2004-06-01
148,平野区,201222,96425,104797,83055,2004-06-01
149,西成区,135411,79065,56346,79505,2004-06-01
150,大阪市,2627049,1281523,1345526,1231164,2004-07-01
151,北区,98023,47293,50730,53057,2004-07-01
152,都島区,99462,48535,50927,45870,2004-07-01
153,福島区,59234,28105,31129,28509,2004-07-01
154,此花区,64694,31569,33125,28071,2004-07-01
155,中央区,63969,29638,34331,37208,2004-07-01
156,西区,70503,33502,37001,38978,2004-07-01
157,港区,83898,41163,42735,37781,2004-07-01
158,大正区,74004,36627,37377,31228,2004-07-01
159,天王寺区,62304,29037,33267,29625,2004-07-01
160,浪速区,53394,27414,25980,33334,2004-07-01
161,西淀川区,95702,47461,48241,40746,2004-07-01
162,淀川区,168240,83431,84809,84820,2004-07-01
163,東淀川区,180502,89981,90521,89696,2004-07-01
164,東成区,79201,37763,41438,36072,2004-07-01
165,生野区,140038,66822,73216,61257,2004-07-01
166,旭区,96468,46239,50229,43919,2004-07-01
167,城東区,160085,76710,83375,70805,2004-07-01
168,鶴見区,106188,51559,54629,41652,2004-07-01
169,阿倍野区,106519,49497,57022,47233,2004-07-01
170,住之江区,131937,63644,68293,55036,2004-07-01
171,住吉区,159837,75364,84473,73147,2004-07-01
172,東住吉区,136237,64684,71553,60412,2004-07-01
173,平野区,201276,96432,104844,83140,2004-07-01
174,西成区,135334,79053,56281,79568,2004-07-01
175,大阪市,2626631,1281193,1345438,1231794,2004-08-01
176,北区,98126,47341,50785,53130,2004-08-01
177,都島区,99460,48528,50932,45911,2004-08-01
178,福島区,59241,28106,31135,28545,2004-08-01
179,此花区,64639,31533,33106,28070,2004-08-01
180,中央区,64073,29686,34387,37370,2004-08-01
181,西区,70694,33593,37101,39158,2004-08-01
182,港区,83819,41117,42702,37764,2004-08-01
183,大正区,73943,36591,37352,31238,2004-08-01
184,天王寺区,62472,29110,33362,29758,2004-08-01
185,浪速区,53321,27369,25952,33200,2004-08-01
186,西淀川区,95675,47441,48234,40734,2004-08-01
187,淀川区,168216,83405,84811,84845,2004-08-01
188,東淀川区,180439,89947,90492,89691,2004-08-01
189,東成区,79201,37757,41444,36074,2004-08-01
190,生野区,139914,66764,73150,61300,2004-08-01
191,旭区,96386,46192,50194,43903,2004-08-01
192,城東区,160128,76722,83406,70880,2004-08-01
193,鶴見区,106253,51579,54674,41677,2004-08-01
194,阿倍野区,106465,49473,56992,47225,2004-08-01
195,住之江区,131912,63623,68289,55041,2004-08-01
196,住吉区,159720,75299,84421,73099,2004-08-01
197,東住吉区,136119,64623,71496,60393,2004-08-01
198,平野区,201197,96376,104821,83179,2004-08-01
199,西成区,135218,79018,56200,79609,2004-08-01
200,大阪市,2625030,1280277,1344753,1232446,2004-09-01
201,北区,98079,47316,50763,53122,2004-09-01
202,都島区,99812,48693,51119,46146,2004-09-01
203,福島区,59310,28137,31173,28575,2004-09-01
204,此花区,64629,31518,33111,28086,2004-09-01
205,中央区,63892,29602,34290,37489,2004-09-01
206,西区,70871,33677,37194,39382,2004-09-01
207,港区,83645,41025,42620,37705,2004-09-01
208,大正区,73917,36572,37345,31259,2004-09-01
209,天王寺区,62417,29080,33337,29770,2004-09-01
210,浪速区,53144,27270,25874,33194,2004-09-01
211,西淀川区,95614,47404,48210,40723,2004-09-01
212,淀川区,168047,83308,84739,84849,2004-09-01
213,東淀川区,180243,89848,90395,89658,2004-09-01
214,東成区,79184,37742,41442,36128,2004-09-01
215,生野区,139635,66631,73004,61304,2004-09-01
216,旭区,96255,46122,50133,43852,2004-09-01
217,城東区,160148,76723,83425,70869,2004-09-01
218,鶴見区,106336,51607,54729,41747,2004-09-01
219,阿倍野区,106415,49450,56965,47232,2004-09-01
220,住之江区,131834,63576,68258,55067,2004-09-01
221,住吉区,159510,75189,84321,73088,2004-09-01
222,東住吉区,135953,64539,71414,60348,2004-09-01
223,平野区,201183,96350,104833,83236,2004-09-01
224,西成区,134957,78898,56059,79617,2004-09-01
225,大阪市,2624775,1280023,1344752,1232982,2004-10-01
226,北区,98060,47305,50755,53172,2004-10-01
227,都島区,99965,48762,51203,46250,2004-10-01
228,福島区,59419,28187,31232,28643,2004-10-01
229,此花区,64516,31453,33063,28056,2004-10-01
230,中央区,64146,29720,34426,37759,2004-10-01
231,西区,70973,33725,37248,39496,2004-10-01
232,港区,83564,40979,42585,37628,2004-10-01
233,大正区,73831,36524,37307,31232,2004-10-01
234,天王寺区,62550,29136,33414,29843,2004-10-01
235,浪速区,53084,27231,25853,33237,2004-10-01
236,西淀川区,95637,47409,48228,40715,2004-10-01
237,淀川区,167882,83212,84670,84789,2004-10-01
238,東淀川区,180124,89787,90337,89566,2004-10-01
239,東成区,79078,37686,41392,36068,2004-10-01
240,生野区,139509,66571,72938,61341,2004-10-01
241,旭区,96119,46049,50070,43807,2004-10-01
242,城東区,160154,76717,83437,70846,2004-10-01
243,鶴見区,106730,51787,54943,41968,2004-10-01
244,阿倍野区,106369,49430,56939,47216,2004-10-01
245,住之江区,131740,63521,68219,55057,2004-10-01
246,住吉区,159483,75166,84317,73084,2004-10-01
247,東住吉区,135840,64480,71360,60317,2004-10-01
248,平野区,201147,96314,104833,83242,2004-10-01
249,西成区,134855,78872,55983,79650,2004-10-01
250,大阪市,2625023,1280002,1345021,1233061,2004-11-01
251,北区,98030,47289,50741,53216,2004-11-01
252,都島区,100043,48794,51249,46329,2004-11-01
253,福島区,59458,28203,31255,28700,2004-11-01
254,此花区,64466,31419,33047,28031,2004-11-01
255,中央区,64445,29858,34587,37976,2004-11-01
256,西区,71074,33773,37301,39602,2004-11-01
257,港区,83478,40930,42548,37480,2004-11-01
258,大正区,73781,36493,37288,31213,2004-11-01
259,天王寺区,62555,29134,33421,29856,2004-11-01
260,浪速区,53151,27258,25893,33272,2004-11-01
261,西淀川区,95640,47404,48236,40711,2004-11-01
262,淀川区,167839,83178,84661,84489,2004-11-01
263,東淀川区,179991,89718,90273,89506,2004-11-01
264,東成区,79059,37671,41388,36092,2004-11-01
265,生野区,139497,66565,72932,61361,2004-11-01
266,旭区,96036,46001,50035,43778,2004-11-01
267,城東区,160139,76702,83437,70776,2004-11-01
268,鶴見区,106942,51878,55064,42082,2004-11-01
269,阿倍野区,106745,49606,57139,47409,2004-11-01
270,住之江区,131690,63487,68203,55069,2004-11-01
271,住吉区,159486,75156,84330,73052,2004-11-01
272,東住吉区,135690,64404,71286,60230,2004-11-01
273,平野区,201084,96265,104819,83288,2004-11-01
274,西成区,134704,78816,55888,79543,2004-11-01
275,大阪市,2624948,1279815,1345133,1233267,2004-12-01
276,北区,98136,47338,50798,53291,2004-12-01
277,都島区,100046,48789,51257,46359,2004-12-01
278,福島区,59627,28281,31346,28780,2004-12-01
279,此花区,64493,31423,33070,28043,2004-12-01
280,中央区,64444,29858,34586,38109,2004-12-01
281,西区,71187,33826,37361,39744,2004-12-01
282,港区,83309,40841,42468,37412,2004-12-01
283,大正区,73727,36460,37267,30986,2004-12-01
284,天王寺区,62920,29299,33621,30054,2004-12-01
285,浪速区,53147,27248,25899,33336,2004-12-01
286,西淀川区,95611,47383,48228,40699,2004-12-01
287,淀川区,167839,83164,84675,84344,2004-12-01
288,東淀川区,179788,89615,90173,89445,2004-12-01
289,東成区,78941,37608,41333,36068,2004-12-01
290,生野区,139331,66486,72845,61354,2004-12-01
291,旭区,95943,45949,49994,43769,2004-12-01
292,城東区,160263,76752,83511,70881,2004-12-01
293,鶴見区,107138,51961,55177,42178,2004-12-01
294,阿倍野区,106828,49646,57182,47424,2004-12-01
295,住之江区,131851,63556,68295,55182,2004-12-01
296,住吉区,159402,75106,84296,73023,2004-12-01
297,東住吉区,135523,64320,71203,60175,2004-12-01
298,平野区,201031,96221,104810,83265,2004-12-01
299,西成区,134423,78685,55738,79346,2004-12-01
