,area,total,men,women,household,date
0,大阪市,2601892,1277801,1324091,1104028,1996-01-01
1,西成区,141656,79737,61919,73972,1996-01-01
2,平野区,200636,97612,103024,76631,1996-01-01
3,東住吉区,141532,67837,73695,58413,1996-01-01
4,住吉区,162656,77947,84709,70218,1996-01-01
5,住之江区,138826,67595,71231,52388,1996-01-01
6,阿倍野区,102696,48065,54631,43043,1996-01-01
7,城東区,155717,75472,80245,64220,1996-01-01
8,旭区,102458,49543,52915,43577,1996-01-01
9,生野区,148836,71195,77641,58462,1996-01-01
10,東成区,78462,37598,40864,32554,1996-01-01
11,東淀川区,186179,93629,92550,84784,1996-01-01
12,鶴見区,98043,48386,49657,35794,1996-01-01
13,西淀川区,91047,45510,45537,36085,1996-01-01
14,淀川区,162037,80923,81114,74234,1996-01-01
15,都島区,98054,48074,49980,41590,1996-01-01
16,福島区,55023,26410,28613,23116,1996-01-01
17,此花区,68486,34371,34115,27517,1996-01-01
18,中央区,52887,24331,28556,25300,1996-01-01
19,北区,85630,40908,44722,39155,1996-01-01
20,港区,89285,44516,44769,36677,1996-01-01
21,大正区,78273,39242,39031,30404,1996-01-01
22,天王寺区,55685,25831,29854,23852,1996-01-01
23,浪速区,48973,24923,24050,25958,1996-01-01
24,西区,58815,28146,30669,26084,1996-01-01
25,東成区,78530,37632,40898,32573,1996-02-01
26,生野区,148802,71175,77627,58472,1996-02-01
27,旭区,102449,49538,52911,43586,1996-02-01
28,城東区,155661,75436,80225,64200,1996-02-01
29,鶴見区,98113,48415,49698,35816,1996-02-01
30,住吉区,162623,77918,84705,70207,1996-02-01
31,住之江区,138797,67577,71220,52425,1996-02-01
32,東住吉区,141492,67811,73681,58414,1996-02-01
33,平野区,200531,97549,102982,76704,1996-02-01
34,西成区,141542,79698,61844,73987,1996-02-01
35,阿倍野区,102694,48057,54637,43069,1996-02-01
36,東淀川区,186124,93589,92535,84783,1996-02-01
37,中央区,52793,24291,28502,25319,1996-02-01
38,西淀川区,91063,45517,45546,36086,1996-02-01
39,淀川区,161960,80885,81075,74224,1996-02-01
40,北区,85644,40923,44721,39222,1996-02-01
41,都島区,98078,48086,49992,41639,1996-02-01
42,福島区,54981,26385,28596,23120,1996-02-01
43,此花区,68474,34356,34118,27504,1996-02-01
44,大阪市,2601265,1277441,1323824,1104433,1996-02-01
45,西区,58837,28153,30684,26109,1996-02-01
46,港区,89225,44480,44745,36680,1996-02-01
47,大正区,78195,39199,38996,30385,1996-02-01
48,天王寺区,55638,25815,29823,23863,1996-02-01
49,浪速区,49019,24956,24063,26046,1996-02-01
50,生野区,148672,71110,77562,58459,1996-03-01
51,旭区,102393,49509,52884,43568,1996-03-01
52,城東区,155696,75445,80251,64287,1996-03-01
53,鶴見区,98122,48414,49708,35846,1996-03-01
54,阿倍野区,102664,48036,54628,43041,1996-03-01
55,住吉区,162568,77878,84690,70226,1996-03-01
56,東成区,78508,37623,40885,32562,1996-03-01
57,東住吉区,141379,67749,73630,58432,1996-03-01
58,平野区,200521,97533,102988,76774,1996-03-01
59,西成区,141468,79682,61786,74035,1996-03-01
60,住之江区,138822,67586,71236,52508,1996-03-01
61,東淀川区,185940,93483,92457,84726,1996-03-01
62,中央区,52792,24294,28498,25358,1996-03-01
63,西淀川区,91041,45504,45537,36088,1996-03-01
64,北区,85557,40889,44668,39270,1996-03-01
65,都島区,98074,48085,49989,41665,1996-03-01
66,福島区,54955,26369,28586,23113,1996-03-01
67,此花区,68426,34324,34102,27479,1996-03-01
68,大阪市,2600322,1276926,1323396,1104887,1996-03-01
69,淀川区,161838,80825,81013,74202,1996-03-01
70,港区,89180,44450,44730,36686,1996-03-01
71,大正区,78084,39140,38944,30374,1996-03-01
72,天王寺区,55651,25827,29824,23884,1996-03-01
73,浪速区,49051,24982,24069,26140,1996-03-01
74,西区,58920,28189,30731,26164,1996-03-01
75,東成区,78403,37574,40829,32650,1996-04-01
76,生野区,148421,70987,77434,58626,1996-04-01
77,旭区,102144,49388,52756,43553,1996-04-01
78,城東区,155392,75289,80103,64354,1996-04-01
79,鶴見区,98039,48368,49671,35904,1996-04-01
80,西成区,141437,79690,61747,74173,1996-04-01
81,住之江区,138382,67369,71013,52528,1996-04-01
82,東住吉区,141205,67659,73546,58489,1996-04-01
83,平野区,200045,97290,102755,76782,1996-04-01
84,東淀川区,185091,93044,92047,84601,1996-04-01
85,阿倍野区,102388,47900,54488,42904,1996-04-01
86,住吉区,162139,77659,84480,70165,1996-04-01
87,淀川区,161842,80827,81015,74508,1996-04-01
88,浪速区,49079,25006,24073,26256,1996-04-01
89,西淀川区,90956,45461,45495,36086,1996-04-01
90,大阪市,2595583,1274572,1321011,1105913,1996-04-01
91,北区,85429,40837,44592,39357,1996-04-01
92,福島区,54885,26332,28553,23163,1996-04-01
93,此花区,68251,34227,34024,27475,1996-04-01
94,都島区,97977,48038,49939,41795,1996-04-01
95,西区,58780,28119,30661,26201,1996-04-01
96,港区,89016,44362,44654,36712,1996-04-01
97,大正区,77908,39048,38860,30379,1996-04-01
98,天王寺区,55719,25864,29855,23941,1996-04-01
99,中央区,52655,24234,28421,25311,1996-04-01
100,鶴見区,98124,48405,49719,35979,1996-05-01
101,生野区,148431,70988,77443,58642,1996-05-01
102,旭区,102244,49435,52809,43786,1996-05-01
103,城東区,155627,75395,80232,64613,1996-05-01
104,阿倍野区,102694,48036,54658,43339,1996-05-01
105,東成区,78486,37615,40871,32683,1996-05-01
106,住吉区,162764,77945,84819,70699,1996-05-01
107,東住吉区,141434,67761,73673,58690,1996-05-01
108,平野区,200293,97400,102893,77047,1996-05-01
109,西成区,141452,79724,61728,74152,1996-05-01
110,住之江区,138325,67338,70987,52659,1996-05-01
111,東淀川区,185675,93324,92351,85404,1996-05-01
112,中央区,53033,24411,28622,25736,1996-05-01
113,西淀川区,91168,45565,45603,36286,1996-05-01
114,大阪市,2600877,1277087,1323790,1111281,1996-05-01
115,北区,85982,41110,44872,39884,1996-05-01
116,都島区,98073,48086,49987,41870,1996-05-01
117,福島区,55038,26401,28637,23288,1996-05-01
118,此花区,68202,34194,34008,27535,1996-05-01
119,淀川区,162406,81109,81297,74739,1996-05-01
120,西区,59038,28239,30799,26393,1996-05-01
121,港区,89236,44464,44772,36901,1996-05-01
122,大正区,77925,39052,38873,30482,1996-05-01
123,天王寺区,56035,26017,30018,24139,1996-05-01
124,浪速区,49192,25073,24119,26335,1996-05-01
125,西成区,141323,79677,61646,74170,1996-06-01
126,平野区,200358,97420,102938,77168,1996-06-01
127,東住吉区,141458,67766,73692,58787,1996-06-01
128,住吉区,162850,77973,84877,70760,1996-06-01
129,住之江区,138348,67346,71002,52730,1996-06-01
130,阿倍野区,102621,47995,54626,43360,1996-06-01
131,鶴見区,98160,48418,49742,36042,1996-06-01
132,城東区,155574,75361,80213,64662,1996-06-01
133,旭区,102307,49464,52843,43846,1996-06-01
134,東成区,78511,37629,40882,32760,1996-06-01
135,東淀川区,186024,93487,92537,85652,1996-06-01
136,生野区,148339,70941,77398,58652,1996-06-01
137,大阪市,2601647,1277413,1324234,1113039,1996-06-01
138,西淀川区,91161,45561,45600,36338,1996-06-01
139,北区,86081,41165,44916,40069,1996-06-01
140,都島区,98132,48116,50016,41913,1996-06-01
141,福島区,55042,26399,28643,23303,1996-06-01
142,此花区,68177,34173,34004,27540,1996-06-01
143,中央区,53149,24468,28681,25853,1996-06-01
144,淀川区,162540,81176,81364,74929,1996-06-01
145,港区,89223,44451,44772,36934,1996-06-01
146,大正区,77882,39027,38855,30558,1996-06-01
147,天王寺区,56077,26042,30035,24194,1996-06-01
148,浪速区,49199,25087,24112,26380,1996-06-01
149,西区,59111,28271,30840,26439,1996-06-01
150,東成区,78589,37668,40921,32798,1996-07-01
151,生野区,148388,70961,77427,58736,1996-07-01
152,旭区,102270,49445,52825,43848,1996-07-01
153,城東区,155536,75334,80202,64688,1996-07-01
154,鶴見区,98139,48403,49736,36059,1996-07-01
155,住之江区,138271,67305,70966,52742,1996-07-01
156,住吉区,162892,77979,84913,70788,1996-07-01
157,東住吉区,141451,67755,73696,58810,1996-07-01
158,平野区,200401,97429,102972,77236,1996-07-01
159,西成区,141225,79647,61578,74197,1996-07-01
160,阿倍野区,102608,47982,54626,43368,1996-07-01
161,東淀川区,186108,93516,92592,85735,1996-07-01
162,淀川区,162477,81145,81332,74939,1996-07-01
163,浪速区,49264,25129,24135,26460,1996-07-01
164,大阪市,2601851,1277455,1324396,1113954,1996-07-01
165,北区,86127,41196,44931,40162,1996-07-01
166,都島区,98136,48119,50017,41947,1996-07-01
167,福島区,55080,26414,28666,23349,1996-07-01
168,此花区,68087,34120,33967,27517,1996-07-01
169,西淀川区,91190,45574,45616,36394,1996-07-01
170,西区,59179,28300,30879,26503,1996-07-01
171,港区,89279,44472,44807,36971,1996-07-01
172,大正区,77859,39012,38847,30590,1996-07-01
173,天王寺区,56126,26070,30056,24236,1996-07-01
174,中央区,53169,24480,28689,25881,1996-07-01
175,東成区,78582,37666,40916,32758,1996-08-01
176,生野区,148268,70900,77368,58643,1996-08-01
177,旭区,102455,49533,52922,43944,1996-08-01
178,城東区,155455,75286,80169,64678,1996-08-01
179,鶴見区,98159,48407,49752,36040,1996-08-01
180,住之江区,138487,67407,71080,52848,1996-08-01
181,住吉区,162818,77931,84887,70739,1996-08-01
182,東住吉区,141405,67726,73679,58815,1996-08-01
183,平野区,200361,97399,102962,77271,1996-08-01
184,東淀川区,186015,93457,92558,85668,1996-08-01
185,阿倍野区,102537,47942,54595,43352,1996-08-01
186,西成区,141075,79588,61487,74147,1996-08-01
187,淀川区,162439,81127,81312,75038,1996-08-01
188,浪速区,49270,25142,24128,26491,1996-08-01
189,西淀川区,91155,45555,45600,36333,1996-08-01
190,大阪市,2601179,1277070,1324109,1113903,1996-08-01
191,北区,86199,41239,44960,40236,1996-08-01
192,福島区,55054,26397,28657,23316,1996-08-01
193,此花区,67963,34049,33914,27494,1996-08-01
194,都島区,98139,48121,50018,41943,1996-08-01
195,西区,59064,28241,30823,26408,1996-08-01
196,港区,89291,44471,44820,37009,1996-08-01
197,大正区,77747,38952,38795,30566,1996-08-01
198,天王寺区,56096,26062,30034,24232,1996-08-01
199,中央区,53145,24472,28673,25934,1996-08-01
200,城東区,155670,75382,80288,64763,1996-09-01
201,東成区,78502,37629,40873,32738,1996-09-01
202,生野区,148124,70828,77296,58648,1996-09-01
203,旭区,102332,49473,52859,43921,1996-09-01
204,阿倍野区,102520,47927,54593,43372,1996-09-01
205,東淀川区,185861,93367,92494,85675,1996-09-01
206,住吉区,162877,77945,84932,70783,1996-09-01
207,東住吉区,141348,67691,73657,58780,1996-09-01
208,平野区,200356,97385,102971,77323,1996-09-01
209,西成区,140871,79498,61373,74105,1996-09-01
210,住之江区,138544,67432,71112,52945,1996-09-01
211,淀川区,162164,80990,81174,75003,1996-09-01
212,鶴見区,98205,48425,49780,36074,1996-09-01
213,浪速区,49220,25126,24094,26522,1996-09-01
214,北区,86435,41360,45075,40392,1996-09-01
215,都島区,98094,48100,49994,41949,1996-09-01
216,福島区,54952,26345,28607,23301,1996-09-01
217,此花区,67994,34056,33938,27485,1996-09-01
218,中央区,53096,24453,28643,25961,1996-09-01
219,大阪市,2600420,1276636,1323784,1114426,1996-09-01
220,西区,59080,28246,30834,26464,1996-09-01
221,港区,89262,44449,44813,37038,1996-09-01
222,大正区,77751,38950,38801,30624,1996-09-01
223,天王寺区,56051,26047,30004,24228,1996-09-01
224,西淀川区,91111,45532,45579,36332,1996-09-01
225,生野区,148026,70778,77248,58707,1996-10-01
226,旭区,102282,49447,52835,44032,1996-10-01
227,城東区,155663,75370,80293,64899,1996-10-01
228,鶴見区,98360,48496,49864,36180,1996-10-01
229,阿倍野区,102593,47955,54638,43503,1996-10-01
230,住吉区,162857,77922,84935,70963,1996-10-01
231,東住吉区,141225,67625,73600,58824,1996-10-01
232,平野区,200479,97433,103046,77504,1996-10-01
233,西成区,140806,79487,61319,74197,1996-10-01
234,東成区,78467,37614,40853,32863,1996-10-01
235,住之江区,138713,67511,71202,53076,1996-10-01
236,東淀川区,185811,93329,92482,85761,1996-10-01
237,淀川区,162032,80924,81108,75137,1996-10-01
238,西淀川区,91073,45512,45561,36363,1996-10-01
239,北区,86371,41338,45033,40513,1996-10-01
240,都島区,98073,48090,49983,42019,1996-10-01
241,福島区,54889,26310,28579,23306,1996-10-01
242,此花区,67938,34020,33918,27467,1996-10-01
243,中央区,53127,24470,28657,26081,1996-10-01
244,大阪市,2600058,1276407,1323651,1116813,1996-10-01
245,港区,89208,44416,44792,37110,1996-10-01
246,大正区,77707,38924,38783,30697,1996-10-01
247,天王寺区,56042,26049,29993,24302,1996-10-01
248,浪速区,49258,25155,24103,26733,1996-10-01
249,西区,59058,28232,30826,26576,1996-10-01
250,生野区,147921,70725,77196,58668,1996-11-01
251,旭区,102246,49429,52817,43954,1996-11-01
252,城東区,155658,75359,80299,64851,1996-11-01
253,鶴見区,98453,48537,49916,36228,1996-11-01
254,阿倍野区,102521,47914,54607,43423,1996-11-01
255,住吉区,163018,77986,85032,70922,1996-11-01
256,東住吉区,141225,67618,73607,58816,1996-11-01
257,平野区,200558,97460,103098,77457,1996-11-01
258,西成区,140627,79411,61216,74132,1996-11-01
259,東成区,78351,37559,40792,32754,1996-11-01
260,住之江区,138769,67535,71234,53093,1996-11-01
261,東淀川区,185692,93256,92436,85708,1996-11-01
262,淀川区,161949,80883,81066,74938,1996-11-01
263,西淀川区,90984,45466,45518,36298,1996-11-01
264,北区,86389,41355,45034,40526,1996-11-01
265,都島区,98187,48147,50040,41983,1996-11-01
266,福島区,54870,26298,28572,23274,1996-11-01
267,此花区,67873,33979,33894,27413,1996-11-01
268,中央区,53150,24484,28666,26054,1996-11-01
269,大阪市,2599692,1276165,1323527,1115755,1996-11-01
270,港区,89298,44453,44845,37147,1996-11-01
271,大正区,77575,38854,38721,30649,1996-11-01
272,天王寺区,56033,26050,29983,24257,1996-11-01
273,浪速区,49244,25158,24086,26680,1996-11-01
274,西区,59101,28249,30852,26530,1996-11-01
275,生野区,147752,70641,77111,58628,1996-12-01
276,旭区,102139,49376,52763,43932,1996-12-01
277,城東区,155649,75347,80302,64930,1996-12-01
278,鶴見区,98586,48598,49988,36303,1996-12-01
279,阿倍野区,102550,47921,54629,43474,1996-12-01
280,住吉区,163007,77967,85040,70959,1996-12-01
281,東住吉区,141225,67611,73614,58843,1996-12-01
282,平野区,200678,97507,103171,77585,1996-12-01
283,西成区,140516,79374,61142,74133,1996-12-01
284,東成区,78333,37552,40781,32756,1996-12-01
285,住之江区,138854,67573,71281,53165,1996-12-01
286,東淀川区,185559,93176,92383,85678,1996-12-01
287,淀川区,161763,80790,80973,74910,1996-12-01
288,西淀川区,90967,45456,45511,36285,1996-12-01
289,北区,86455,41395,45060,40642,1996-12-01
290,都島区,98212,48160,50052,42017,1996-12-01
291,福島区,54843,26281,28562,23251,1996-12-01
292,此花区,67802,33935,33867,27383,1996-12-01
293,中央区,53118,24472,28646,26085,1996-12-01
294,大阪市,2599329,1275928,1323401,1116325,1996-12-01
295,港区,89304,44450,44854,37150,1996-12-01
296,大正区,77543,38834,38709,30670,1996-12-01
297,天王寺区,56038,26058,29980,24242,1996-12-01
298,浪速区,49175,25132,24043,26688,1996-12-01
299,西区,59261,28322,30939,26616,1996-12-01
300,東成区,78259,37518,40741,32753,1997-01-01
301,生野区,147591,70560,77031,58642,1997-01-01
302,旭区,102194,49401,52793,43979,1997-01-01
303,城東区,155639,75333,80306,64919,1997-01-01
304,鶴見区,98709,48653,50056,36354,1997-01-01
305,住之江区,138918,67601,71317,53227,1997-01-01
306,住吉区,162993,77947,85046,70950,1997-01-01
307,東住吉区,141188,67586,73602,58857,1997-01-01
308,平野区,200781,97546,103235,77709,1997-01-01
309,東淀川区,185478,93123,92355,85662,1997-01-01
310,阿倍野区,102600,47937,54663,43511,1997-01-01
311,淀川区,161636,80727,80909,74881,1997-01-01
312,西成区,140324,79290,61034,74087,1997-01-01
313,浪速区,49124,25116,24008,26714,1997-01-01
314,大阪市,2598720,1275564,1323156,1116638,1997-01-01
315,北区,86480,41416,45064,40708,1997-01-01
316,都島区,98133,48122,50011,41985,1997-01-01
317,福島区,54784,26249,28535,23248,1997-01-01
318,此花区,67699,33875,33824,27343,1997-01-01
319,西淀川区,90934,45438,45496,36284,1997-01-01
320,西区,59361,28367,30994,26659,1997-01-01
321,港区,89249,44415,44834,37140,1997-01-01
322,大正区,77489,38804,38685,30664,1997-01-01
323,天王寺区,56063,26076,29987,24258,1997-01-01
324,中央区,53094,24464,28630,26104,1997-01-01
325,生野区,147422,70476,76946,58624,1997-02-01
326,旭区,102083,49346,52737,43951,1997-02-01
327,城東区,155599,75306,80293,64944,1997-02-01
328,鶴見区,98705,48646,50059,36356,1997-02-01
329,阿倍野区,102452,47861,54591,43468,1997-02-01
330,住吉区,162936,77906,85030,70937,1997-02-01
331,東住吉区,141076,67525,73551,58859,1997-02-01
332,平野区,200664,97478,103186,77697,1997-02-01
333,西成区,140243,79270,60973,74149,1997-02-01
334,東成区,78183,37483,40700,32766,1997-02-01
335,住之江区,138919,67598,71321,53250,1997-02-01
336,東淀川区,185176,92958,92218,85548,1997-02-01
337,淀川区,161503,80661,80842,74894,1997-02-01
338,西淀川区,90870,45405,45465,36277,1997-02-01
339,北区,86649,41505,45144,40835,1997-02-01
340,都島区,97998,48056,49942,41930,1997-02-01
341,福島区,54674,26192,28482,23206,1997-02-01
342,此花区,67603,33818,33785,27297,1997-02-01
343,中央区,53070,24456,28614,26112,1997-02-01
344,大阪市,2596877,1274607,1322270,1116562,1997-02-01
345,港区,89127,44348,44779,37121,1997-02-01
346,大正区,77409,38760,38649,30666,1997-02-01
347,天王寺区,56050,26075,29975,24273,1997-02-01
348,浪速区,49068,25097,23971,26738,1997-02-01
349,西区,59398,28381,31017,26664,1997-02-01
350,東成区,78121,37455,40666,32745,1997-03-01
351,生野区,147314,70422,76892,58674,1997-03-01
352,旭区,102010,49310,52700,43946,1997-03-01
353,城東区,155627,75311,80316,64865,1997-03-01
354,鶴見区,98761,48669,50092,36399,1997-03-01
355,住之江区,138931,67601,71330,53287,1997-03-01
356,住吉区,162756,77807,84949,70907,1997-03-01
357,東住吉区,140980,67472,73508,58849,1997-03-01
358,平野区,200866,97564,103302,77884,1997-03-01
359,東淀川区,185205,92960,92245,85718,1997-03-01
360,阿倍野区,102509,47881,54628,43562,1997-03-01
361,淀川区,161444,80632,80812,74947,1997-03-01
362,西成区,140170,79254,60916,74115,1997-03-01
363,浪速区,49053,25099,23954,26817,1997-03-01
364,大阪市,2596023,1274144,1321879,1117259,1997-03-01
365,北区,86701,41539,45162,40890,1997-03-01
366,都島区,97909,48014,49895,41962,1997-03-01
367,福島区,54665,26184,28481,23264,1997-03-01
368,此花区,67495,33756,33739,27277,1997-03-01
369,西淀川区,90744,45341,45403,36254,1997-03-01
370,西区,59326,28343,30983,26671,1997-03-01
371,港区,89015,44285,44730,37129,1997-03-01
372,大正区,77353,38728,38625,30670,1997-03-01
373,天王寺区,56047,26080,29967,24272,1997-03-01
374,中央区,53021,24437,28584,26155,1997-03-01
375,東成区,78205,37497,40708,32920,1997-04-01
376,生野区,147044,70289,76755,58692,1997-04-01
377,旭区,101690,49154,52536,43852,1997-04-01
378,城東区,155319,75153,80166,64859,1997-04-01
379,鶴見区,98744,48655,50089,36507,1997-04-01
380,住之江区,138339,67309,71030,53254,1997-04-01
381,住吉区,162467,77655,84812,71011,1997-04-01
382,東住吉区,140772,67365,73407,58929,1997-04-01
383,平野区,200559,97404,103155,77976,1997-04-01
384,東淀川区,184520,92604,91916,85582,1997-04-01
385,阿倍野区,102366,47808,54558,43496,1997-04-01
386,淀川区,161144,80482,80662,75135,1997-04-01
387,西成区,140023,79196,60827,74231,1997-04-01
388,浪速区,49087,25126,23961,26959,1997-04-01
389,大阪市,2592504,1272369,1320135,1118964,1997-04-01
390,北区,86680,41537,45143,41060,1997-04-01
391,都島区,97875,47998,49877,42075,1997-04-01
392,福島区,54597,26147,28450,23314,1997-04-01
393,此花区,67298,33649,33649,27282,1997-04-01
394,西淀川区,91233,45584,45649,36580,1997-04-01
395,西区,59387,28369,31018,26810,1997-04-01
396,港区,88906,44224,44682,37241,1997-04-01
397,大正区,77212,38654,38558,30668,1997-04-01
398,天王寺区,55898,26016,29882,24297,1997-04-01
399,中央区,53139,24494,28645,26234,1997-04-01
400,東成区,78468,37624,40844,33151,1997-05-01
401,生野区,147243,70381,76862,58922,1997-05-01
402,旭区,101847,49229,52618,44098,1997-05-01
403,城東区,155621,75291,80330,65125,1997-05-01
404,鶴見区,98983,48768,50215,36730,1997-05-01
405,住之江区,138400,67336,71064,53409,1997-05-01
406,住吉区,162922,77859,85063,71392,1997-05-01
407,東住吉区,140961,67449,73512,59183,1997-05-01
408,平野区,200864,97541,103323,78292,1997-05-01
409,東淀川区,184980,92822,92158,86127,1997-05-01
410,阿倍野区,102687,47951,54736,43847,1997-05-01
411,西成区,140057,79240,60817,74409,1997-05-01
412,淀川区,161618,80719,80899,75594,1997-05-01
413,浪速区,49348,25269,24079,27191,1997-05-01
414,西淀川区,91393,45663,45730,36753,1997-05-01
415,大阪市,2597962,1274970,1322992,1125097,1997-05-01
416,北区,87239,41813,45426,41560,1997-05-01
417,福島区,54722,26203,28519,23498,1997-05-01
418,此花区,67253,33618,33635,27355,1997-05-01
419,都島区,97958,48039,49919,42229,1997-05-01
420,西区,59583,28459,31124,27059,1997-05-01
421,港区,89003,44265,44738,37390,1997-05-01
422,大正区,77232,38660,38572,30728,1997-05-01
423,天王寺区,56229,26176,30053,24570,1997-05-01
424,中央区,53351,24595,28756,26485,1997-05-01
425,鶴見区,99144,48842,50302,36798,1997-06-01
426,生野区,147141,70329,76812,58971,1997-06-01
427,旭区,101826,49217,52609,44139,1997-06-01
428,城東区,155587,75266,80321,65178,1997-06-01
429,阿倍野区,102709,47954,54755,43903,1997-06-01
430,東成区,78483,37633,40850,33204,1997-06-01
431,住吉区,162897,77834,85063,71392,1997-06-01
432,東住吉区,140963,67443,73520,59235,1997-06-01
433,平野区,200930,97561,103369,78388,1997-06-01
434,西成区,140014,79241,60773,74485,1997-06-01
435,住之江区,138349,67308,71041,53429,1997-06-01
436,東淀川区,185191,92915,92276,86324,1997-06-01
437,中央区,53314,24581,28733,26502,1997-06-01
438,西淀川区,91532,45731,45801,36894,1997-06-01
439,北区,87480,41938,45542,41747,1997-06-01
440,都島区,97832,47978,49854,42235,1997-06-01
441,福島区,54837,26255,28582,23593,1997-06-01
442,此花区,67204,33585,33619,27350,1997-06-01
443,淀川区,161606,80714,80892,75736,1997-06-01
444,大阪市,2598450,1275162,1323288,1126714,1997-06-01
445,港区,88961,44237,44724,37411,1997-06-01
446,大正区,77172,38626,38546,30739,1997-06-01
447,天王寺区,56241,26187,30054,24630,1997-06-01
448,浪速区,49390,25300,24090,27269,1997-06-01
449,西区,59647,28487,31160,27162,1997-06-01
450,生野区,147084,70299,76785,59060,1997-07-01
451,旭区,101872,49238,52634,44184,1997-07-01
452,城東区,155706,75316,80390,65314,1997-07-01
453,鶴見区,99261,48894,50367,36883,1997-07-01
454,阿倍野区,102840,48008,54832,44001,1997-07-01
455,住吉区,162886,77815,85071,71389,1997-07-01
456,東住吉区,140885,67398,73487,59256,1997-07-01
457,平野区,201020,97594,103426,78460,1997-07-01
458,西成区,139918,79212,60706,74513,1997-07-01
459,東成区,78382,37586,40796,33213,1997-07-01
460,住之江区,138316,67289,71027,53430,1997-07-01
461,東淀川区,185114,92863,92251,86305,1997-07-01
462,淀川区,161735,80779,80956,75861,1997-07-01
463,西淀川区,91509,45718,45791,36905,1997-07-01
464,北区,87502,41957,45545,41818,1997-07-01
465,都島区,97720,47924,49796,42201,1997-07-01
466,福島区,54861,26262,28599,23617,1997-07-01
467,此花区,67140,33545,33595,27313,1997-07-01
468,中央区,53269,24564,28705,26535,1997-07-01
469,大阪市,2598413,1275094,1323319,1127567,1997-07-01
470,港区,88934,44217,44717,37415,1997-07-01
471,大正区,77142,38607,38535,30739,1997-07-01
472,天王寺区,56224,26185,30039,24653,1997-07-01
473,浪速区,49511,25372,24139,27374,1997-07-01
474,西区,59582,28452,31130,27128,1997-07-01
475,生野区,146927,70220,76707,59063,1997-08-01
476,旭区,101817,49211,52606,44163,1997-08-01
477,城東区,156042,75470,80572,65468,1997-08-01
478,鶴見区,99236,48877,50359,36904,1997-08-01
479,阿倍野区,103146,48144,55002,44150,1997-08-01
480,住吉区,162708,77717,84991,71336,1997-08-01
481,東住吉区,140719,67311,73408,59219,1997-08-01
482,平野区,201042,97593,103449,78499,1997-08-01
483,西成区,139704,79116,60588,74460,1997-08-01
484,東成区,78288,37542,40746,33206,1997-08-01
485,住之江区,138314,67284,71030,53457,1997-08-01
486,東淀川区,185061,92824,92237,86336,1997-08-01
487,淀川区,161660,80741,80919,75875,1997-08-01
488,西淀川区,91461,45693,45768,36882,1997-08-01
489,北区,87540,41984,45556,41883,1997-08-01
490,都島区,97693,47911,49782,42223,1997-08-01
491,福島区,54864,26260,28604,23631,1997-08-01
492,此花区,66979,33456,33523,27252,1997-08-01
493,中央区,53248,24557,28691,26564,1997-08-01
494,大阪市,2598081,1274867,1323214,1128127,1997-08-01
495,港区,88932,44209,44723,37458,1997-08-01
496,大正区,77054,38560,38494,30730,1997-08-01
497,天王寺区,56247,26201,30046,24690,1997-08-01
498,浪速区,49789,25524,24265,27514,1997-08-01
499,西区,59610,28462,31148,27164,1997-08-01
500,生野区,146785,70149,76636,59024,1997-09-01
501,旭区,101687,49147,52540,44131,1997-09-01
502,城東区,156142,75510,80632,65536,1997-09-01
503,鶴見区,99163,48836,50327,36891,1997-09-01
504,阿倍野区,103180,48153,55027,44189,1997-09-01
505,住吉区,162652,77677,84975,71329,1997-09-01
506,東住吉区,140644,67268,73376,59197,1997-09-01
507,平野区,201064,97592,103472,78535,1997-09-01
508,西成区,139640,79105,60535,74447,1997-09-01
509,東成区,78348,37573,40775,33253,1997-09-01
510,住之江区,138209,67230,70979,53484,1997-09-01
511,東淀川区,184901,92731,92170,86328,1997-09-01
512,淀川区,161529,80676,80853,75866,1997-09-01
513,西淀川区,91485,45704,45781,36927,1997-09-01
514,北区,87703,42070,45633,42028,1997-09-01
515,都島区,97687,47909,49778,42240,1997-09-01
516,福島区,54855,26252,28603,23620,1997-09-01
517,此花区,66897,33407,33490,27238,1997-09-01
518,中央区,53188,24533,28655,26590,1997-09-01
519,大阪市,2597309,1274438,1322871,1128548,1997-09-01
520,港区,88865,44169,44696,37481,1997-09-01
521,大正区,76992,38525,38467,30735,1997-09-01
522,天王寺区,56341,26251,30090,24758,1997-09-01
523,浪速区,49794,25537,24257,27572,1997-09-01
524,西区,59558,28434,31124,27149,1997-09-01
525,生野区,146641,70077,76564,59032,1997-10-01
526,旭区,101594,49101,52493,44100,1997-10-01
527,城東区,156233,75545,80688,65620,1997-10-01
528,鶴見区,99262,48880,50382,36940,1997-10-01
529,阿倍野区,103306,48205,55101,44245,1997-10-01
530,住吉区,162527,77604,84923,71276,1997-10-01
531,東住吉区,140541,67212,73329,59182,1997-10-01
532,平野区,201225,97659,103566,78668,1997-10-01
533,西成区,139514,79059,60455,74456,1997-10-01
534,東成区,78350,37575,40775,33275,1997-10-01
535,住之江区,138066,67157,70909,53489,1997-10-01
536,東淀川区,184840,92688,92152,86326,1997-10-01
537,淀川区,161442,80633,80809,75893,1997-10-01
538,西淀川区,91475,45698,45777,36964,1997-10-01
539,北区,87676,42066,45610,42094,1997-10-01
540,都島区,97726,47929,49797,42277,1997-10-01
541,福島区,54847,26244,28603,23633,1997-10-01
542,此花区,66820,33360,33460,27203,1997-10-01
543,中央区,53150,24518,28632,26607,1997-10-01
544,大阪市,2596502,1273988,1322514,1128947,1997-10-01
545,港区,88782,44121,44661,37467,1997-10-01
546,大正区,76907,38479,38428,30730,1997-10-01
547,天王寺区,56298,26237,30061,24746,1997-10-01
548,浪速区,49748,25523,24225,27579,1997-10-01
549,西区,59532,28418,31114,27145,1997-10-01
550,生野区,146515,70014,76501,58990,1997-11-01
551,旭区,101458,49034,52424,44089,1997-11-01
552,城東区,156289,75564,80725,65750,1997-11-01
553,鶴見区,99359,48922,50437,37019,1997-11-01
554,阿倍野区,103311,48201,55110,44292,1997-11-01
555,住吉区,162396,77528,84868,71313,1997-11-01
556,東住吉区,140477,67174,73303,59165,1997-11-01
557,平野区,201226,97648,103578,78848,1997-11-01
558,西成区,139460,79053,60407,74555,1997-11-01
559,東成区,78288,37547,40741,33286,1997-11-01
560,住之江区,138281,67259,71022,53644,1997-11-01
561,東淀川区,184705,92607,92098,86327,1997-11-01
562,淀川区,161323,80574,80749,75936,1997-11-01
563,西淀川区,91578,45748,45830,37070,1997-11-01
564,北区,87583,42030,45553,42001,1997-11-01
565,都島区,97888,48009,49879,42328,1997-11-01
566,福島区,54932,26281,28651,23677,1997-11-01
567,此花区,66663,33274,33389,27166,1997-11-01
568,中央区,53076,24487,28589,26625,1997-11-01
569,大阪市,2595877,1273634,1322243,1129875,1997-11-01
570,港区,88741,44093,44648,37477,1997-11-01
571,大正区,76779,38411,38368,30754,1997-11-01
572,天王寺区,56294,26241,30053,24784,1997-11-01
573,浪速区,49737,25527,24210,27645,1997-11-01
574,西区,59518,28408,31110,27134,1997-11-01
575,生野区,146314,69914,76400,58996,1997-12-01
576,旭区,101362,48986,52376,44062,1997-12-01
577,城東区,156284,75553,80731,65811,1997-12-01
578,鶴見区,99444,48959,50485,37075,1997-12-01
579,阿倍野区,103257,48168,55089,44308,1997-12-01
580,住吉区,162302,77469,84833,71238,1997-12-01
581,東住吉区,140514,67185,73329,59173,1997-12-01
582,平野区,201322,97683,103639,78947,1997-12-01
583,西成区,139338,79009,60329,74523,1997-12-01
584,東成区,78329,37568,40761,33319,1997-12-01
585,住之江区,138308,67269,71039,53693,1997-12-01
586,東淀川区,184707,92595,92112,86379,1997-12-01
587,淀川区,161328,80577,80751,75940,1997-12-01
588,西淀川区,91525,45720,45805,37052,1997-12-01
589,北区,87561,42028,45533,42075,1997-12-01
590,都島区,97924,48028,49896,42384,1997-12-01
591,福島区,54902,26263,28639,23681,1997-12-01
592,此花区,66616,33242,33374,27156,1997-12-01
593,中央区,53075,24490,28585,26674,1997-12-01
594,大阪市,2595332,1273314,1322018,1130385,1997-12-01
595,港区,88638,44035,44603,37455,1997-12-01
596,大正区,76718,38376,38342,30763,1997-12-01
597,天王寺区,56283,26241,30042,24796,1997-12-01
598,浪速区,49794,25566,24228,27742,1997-12-01
599,西区,59487,28390,31097,27143,1997-12-01
600,生野区,146155,69835,76320,58949,1998-01-01
601,旭区,101275,48943,52332,44049,1998-01-01
602,城東区,156603,75699,80904,65938,1998-01-01
603,鶴見区,99559,49010,50549,37134,1998-01-01
604,阿倍野区,103232,48150,55082,44293,1998-01-01
605,住吉区,162190,77403,84787,71236,1998-01-01
606,東住吉区,140480,67161,73319,59207,1998-01-01
607,平野区,201462,97740,103722,79065,1998-01-01
608,西成区,139187,78949,60238,74469,1998-01-01
609,東成区,78375,37591,40784,33356,1998-01-01
610,住之江区,138315,67269,71046,53742,1998-01-01
611,東淀川区,184756,92607,92149,86452,1998-01-01
612,淀川区,161219,80523,80696,75909,1998-01-01
613,西淀川区,91501,45707,45794,37063,1998-01-01
614,北区,87510,42012,45498,42141,1998-01-01
615,都島区,97905,48019,49886,42374,1998-01-01
616,福島区,54877,26247,28630,23699,1998-01-01
617,此花区,66638,33245,33393,27161,1998-01-01
618,中央区,53049,24481,28568,26662,1998-01-01
619,大阪市,2595034,1273117,1321917,1130813,1998-01-01
620,港区,88534,43977,44557,37406,1998-01-01
621,大正区,76626,38327,38299,30770,1998-01-01
622,天王寺区,56300,26255,30045,24821,1998-01-01
623,浪速区,49867,25613,24254,27781,1998-01-01
624,西区,59419,28354,31065,27136,1998-01-01
625,東成区,78395,37602,40793,33410,1998-02-01
626,生野区,145989,69753,76236,58875,1998-02-01
627,旭区,101179,48895,52284,44013,1998-02-01
628,城東区,156532,75656,80876,65951,1998-02-01
629,鶴見区,99559,49005,50554,37180,1998-02-01
630,住之江区,138301,67259,71042,53760,1998-02-01
631,住吉区,162182,77385,84797,71230,1998-02-01
632,東住吉区,140355,67095,73260,59192,1998-02-01
633,平野区,201375,97686,103689,79060,1998-02-01
634,東淀川区,184728,92580,92148,86442,1998-02-01
635,阿倍野区,103233,48143,55090,44310,1998-02-01
636,淀川区,161055,80441,80614,75863,1998-02-01
637,西成区,139016,78877,60139,74376,1998-02-01
638,浪速区,49882,25631,24251,27787,1998-02-01
639,大阪市,2593807,1272460,1321347,1130763,1998-02-01
640,北区,87453,41993,45460,42165,1998-02-01
641,都島区,97879,48007,49872,42411,1998-02-01
642,福島区,54888,26248,28640,23719,1998-02-01
643,此花区,66528,33181,33347,27101,1998-02-01
644,西淀川区,91505,45708,45797,37114,1998-02-01
645,西区,59420,28351,31069,27145,1998-02-01
646,港区,88492,43949,44543,37419,1998-02-01
647,大正区,76604,38312,38292,30767,1998-02-01
648,天王寺区,56334,26277,30057,24806,1998-02-01
649,中央区,52923,24426,28497,26667,1998-02-01
650,生野区,145833,69675,76158,58854,1998-03-01
651,旭区,101048,48831,52217,43989,1998-03-01
652,城東区,156602,75681,80921,66046,1998-03-01
653,鶴見区,99517,48979,50538,37204,1998-03-01
654,阿倍野区,103082,48066,55016,44272,1998-03-01
655,住吉区,162108,77337,84771,71227,1998-03-01
656,東住吉区,140245,67035,73210,59179,1998-03-01
657,平野区,201296,97637,103659,79138,1998-03-01
658,西成区,138957,78868,60089,74347,1998-03-01
659,東成区,78340,37578,40762,33380,1998-03-01
660,住之江区,138153,67184,70969,53745,1998-03-01
661,東淀川区,184654,92531,92123,86477,1998-03-01
662,淀川区,160969,80399,80570,75917,1998-03-01
663,西淀川区,91491,45699,45792,37153,1998-03-01
664,北区,87580,42063,45517,42222,1998-03-01
665,都島区,97815,47977,49838,42441,1998-03-01
666,福島区,54836,26220,28616,23715,1998-03-01
667,此花区,66449,33134,33315,27077,1998-03-01
668,中央区,52955,24444,28511,26637,1998-03-01
669,大阪市,2592477,1271768,1320709,1131037,1998-03-01
670,港区,88408,43900,44508,37400,1998-03-01
671,大正区,76534,38273,38261,30771,1998-03-01
672,天王寺区,56319,26275,30044,24802,1998-03-01
673,浪速区,49903,25652,24251,27906,1998-03-01
674,西区,59383,28330,31053,27138,1998-03-01
675,生野区,145598,69559,76039,58943,1998-04-01
676,旭区,100847,48732,52115,43983,1998-04-01
677,城東区,156675,75708,80967,66312,1998-04-01
678,鶴見区,99615,49022,50593,37308,1998-04-01
679,阿倍野区,102872,47961,54911,44186,1998-04-01
680,住吉区,161709,77133,84576,71186,1998-04-01
681,東住吉区,140184,66998,73186,59252,1998-04-01
682,平野区,201014,97488,103526,79179,1998-04-01
683,西成区,138769,78787,59982,74425,1998-04-01
684,東成区,78444,37629,40815,33540,1998-04-01
685,住之江区,137850,67033,70817,53750,1998-04-01
686,東淀川区,184283,92332,91951,86601,1998-04-01
687,淀川区,161040,80434,80606,76292,1998-04-01
688,西淀川区,91369,45637,45732,37172,1998-04-01
689,北区,88153,42347,45806,42641,1998-04-01
690,都島区,97495,47821,49674,42454,1998-04-01
691,福島区,54726,26163,28563,23770,1998-04-01
692,此花区,66276,33039,33237,27073,1998-04-01
693,中央区,53162,24543,28619,26857,1998-04-01
694,大阪市,2590364,1270668,1319696,1133220,1998-04-01
695,港区,88343,43861,44482,37504,1998-04-01
696,大正区,76461,38233,38228,30770,1998-04-01
697,天王寺区,56236,26242,29994,24850,1998-04-01
698,浪速区,49852,25635,24217,27935,1998-04-01
699,西区,59391,28331,31060,27237,1998-04-01
700,生野区,145695,69603,76092,59171,1998-05-01
701,旭区,100891,48753,52138,44144,1998-05-01
702,城東区,156848,75783,81065,66591,1998-05-01
703,鶴見区,99709,49064,50645,37463,1998-05-01
704,阿倍野区,103203,48109,55094,44510,1998-05-01
705,住吉区,161794,77160,84634,71392,1998-05-01
706,東住吉区,140371,67081,73290,59484,1998-05-01
707,平野区,201079,97509,103570,79386,1998-05-01
708,西成区,138846,78855,59991,74543,1998-05-01
709,東成区,78555,37684,40871,33700,1998-05-01
710,住之江区,137840,67025,70815,53913,1998-05-01
711,東淀川区,184619,92488,92131,87001,1998-05-01
712,淀川区,161428,80628,80800,76828,1998-05-01
713,西淀川区,91539,45721,45818,37416,1998-05-01
714,北区,88593,42567,46026,43101,1998-05-01
715,都島区,97510,47829,49681,42580,1998-05-01
716,福島区,54871,26229,28642,23916,1998-05-01
717,此花区,66385,33085,33300,27217,1998-05-01
718,中央区,53279,24600,28679,27088,1998-05-01
719,大阪市,2594136,1272460,1321676,1138590,1998-05-01
720,港区,88466,43915,44551,37685,1998-05-01
721,大正区,76453,38225,38228,30842,1998-05-01
722,天王寺区,56506,26374,30132,25055,1998-05-01
723,浪速区,49945,25693,24252,28091,1998-05-01
724,西区,59711,28480,31231,27473,1998-05-01
725,東成区,78568,37691,40877,33731,1998-06-01
726,生野区,145669,69587,76082,59254,1998-06-01
727,旭区,100842,48728,52114,44186,1998-06-01
728,城東区,157008,75852,81156,66700,1998-06-01
729,鶴見区,99792,49099,50693,37523,1998-06-01
730,住之江区,137798,67001,70797,53973,1998-06-01
731,住吉区,161775,77138,84637,71455,1998-06-01
732,東住吉区,140574,67171,73403,59640,1998-06-01
733,平野区,201232,97571,103661,79511,1998-06-01
734,東淀川区,184562,92446,92116,87105,1998-06-01
735,阿倍野区,103162,48083,55079,44507,1998-06-01
736,淀川区,161546,80688,80858,77005,1998-06-01
737,西成区,138773,78839,59934,74586,1998-06-01
738,浪速区,49982,25722,24260,28161,1998-06-01
739,大阪市,2594621,1272644,1321977,1140034,1998-06-01
740,北区,88672,42614,46058,43220,1998-06-01
741,都島区,97520,47834,49686,42622,1998-06-01
742,福島区,54822,26201,28621,23904,1998-06-01
743,此花区,66330,33050,33280,27226,1998-06-01
744,西淀川区,91583,45742,45841,37476,1998-06-01
745,西区,59690,28467,31223,27489,1998-06-01
746,港区,88408,43880,44528,37681,1998-06-01
747,大正区,76450,38220,38230,30864,1998-06-01
748,天王寺区,56531,26392,30139,25085,1998-06-01
749,中央区,53332,24628,28704,27130,1998-06-01
750,生野区,145588,69545,76043,59272,1998-07-01
751,旭区,100825,48718,52107,44191,1998-07-01
752,城東区,157104,75890,81214,66749,1998-07-01
753,鶴見区,99894,49144,50750,37576,1998-07-01
754,阿倍野区,103098,48046,55052,44463,1998-07-01
755,住吉区,161786,77130,84656,71467,1998-07-01
756,東住吉区,140535,67145,73390,59634,1998-07-01
757,平野区,201392,97637,103755,79560,1998-07-01
758,西成区,138757,78855,59902,74610,1998-07-01
759,東成区,78585,37701,40884,33764,1998-07-01
760,住之江区,137791,66995,70796,53985,1998-07-01
761,東淀川区,184703,92504,92199,87179,1998-07-01
762,淀川区,161665,80747,80918,77102,1998-07-01
763,西淀川区,91597,45747,45850,37485,1998-07-01
764,北区,88689,42630,46059,43286,1998-07-01
765,都島区,97524,47837,49687,42626,1998-07-01
766,福島区,54840,26206,28634,23920,1998-07-01
767,此花区,66327,33040,33287,27245,1998-07-01
768,中央区,53362,24645,28717,27168,1998-07-01
769,大阪市,2595412,1272984,1322428,1140780,1998-07-01
770,港区,88473,43905,44568,37711,1998-07-01
771,大正区,76440,38211,38229,30883,1998-07-01
772,天王寺区,56559,26410,30149,25126,1998-07-01
773,浪速区,50073,25778,24295,28217,1998-07-01
774,西区,59805,28518,31287,27561,1998-07-01
775,東成区,78659,37738,40921,33815,1998-08-01
776,生野区,145517,69508,76009,59306,1998-08-01
777,旭区,100904,48755,52149,44261,1998-08-01
778,城東区,157095,75877,81218,66750,1998-08-01
779,鶴見区,99960,49172,50788,37618,1998-08-01
780,住之江区,137737,66965,70772,53950,1998-08-01
781,住吉区,161843,77144,84699,71442,1998-08-01
782,東住吉区,140498,67120,73378,59616,1998-08-01
783,平野区,201537,97696,103841,79587,1998-08-01
784,東淀川区,184732,92506,92226,87129,1998-08-01
785,阿倍野区,103120,48049,55071,44477,1998-08-01
786,淀川区,161618,80724,80894,77034,1998-08-01
787,西成区,138772,78888,59884,74659,1998-08-01
788,浪速区,50064,25784,24280,28226,1998-08-01
789,大阪市,2595922,1273185,1322737,1141227,1998-08-01
790,北区,88751,42669,46082,43427,1998-08-01
791,都島区,97439,47796,49643,42575,1998-08-01
792,福島区,55011,26284,28727,24069,1998-08-01
793,此花区,66294,33015,33279,27208,1998-08-01
794,西淀川区,91702,45799,45903,37566,1998-08-01
795,西区,59870,28546,31324,27645,1998-08-01
796,港区,88431,43877,44554,37680,1998-08-01
797,大正区,76397,38186,38211,30868,1998-08-01
798,天王寺区,56630,26449,30181,25160,1998-08-01
799,中央区,53341,24638,28703,27159,1998-08-01
800,東成区,78650,37735,40915,33805,1998-09-01
801,生野区,145492,69493,75999,59329,1998-09-01
802,旭区,100863,48734,52129,44251,1998-09-01
803,城東区,157182,75911,81271,66850,1998-09-01
804,鶴見区,100060,49216,50844,37640,1998-09-01
805,住之江区,137701,66944,70757,53940,1998-09-01
806,住吉区,161750,77086,84664,71381,1998-09-01
807,東住吉区,140553,67139,73414,59681,1998-09-01
808,平野区,201520,97677,103843,79542,1998-09-01
809,東淀川区,184823,92539,92284,87144,1998-09-01
810,阿倍野区,103071,48020,55051,44467,1998-09-01
811,淀川区,161658,80745,80913,77100,1998-09-01
812,西成区,138724,78886,59838,74666,1998-09-01
813,浪速区,50020,25771,24249,28245,1998-09-01
814,大阪市,2595934,1273142,1322792,1141456,1998-09-01
815,北区,88855,42728,46127,43485,1998-09-01
816,都島区,97358,47757,49601,42534,1998-09-01
817,福島区,55034,26291,28743,24096,1998-09-01
818,此花区,66218,32969,33249,27144,1998-09-01
819,西淀川区,91686,45789,45897,37557,1998-09-01
820,西区,59940,28576,31364,27695,1998-09-01
821,港区,88386,43848,44538,37648,1998-09-01
822,大正区,76362,38165,38197,30863,1998-09-01
823,天王寺区,56664,26471,30193,25200,1998-09-01
824,中央区,53364,24652,28712,27193,1998-09-01
825,東成区,78700,37760,40940,33835,1998-10-01
826,生野区,145495,69491,76004,59319,1998-10-01
827,旭区,100832,48718,52114,44213,1998-10-01
828,城東区,157260,75940,81320,66885,1998-10-01
829,鶴見区,100140,49250,50890,37683,1998-10-01
830,住之江区,137676,66929,70747,53916,1998-10-01
831,住吉区,161774,77084,84690,71389,1998-10-01
832,東住吉区,140591,67150,73441,59709,1998-10-01
833,平野区,201627,97717,103910,79571,1998-10-01
834,東淀川区,184951,92590,92361,87199,1998-10-01
835,阿倍野区,103009,47984,55025,44451,1998-10-01
836,西成区,138695,78894,59801,74657,1998-10-01
837,淀川区,161594,80713,80881,77072,1998-10-01
838,浪速区,49951,25745,24206,28252,1998-10-01
839,西淀川区,91679,45785,45894,37583,1998-10-01
840,大阪市,2596276,1273255,1323021,1141825,1998-10-01
841,北区,88897,42757,46140,43656,1998-10-01
842,福島区,55051,26295,28756,24126,1998-10-01
843,此花区,66153,32929,33224,27115,1998-10-01
844,都島区,97370,47764,49606,42483,1998-10-01
845,西区,60092,28645,31447,27807,1998-10-01
846,港区,88395,43846,44549,37647,1998-10-01
847,大正区,76302,38131,38171,30809,1998-10-01
848,天王寺区,56633,26462,30171,25200,1998-10-01
849,中央区,53409,24676,28733,27248,1998-10-01
850,鶴見区,100201,49275,50926,37705,1998-11-01
851,生野区,145347,69417,75930,59351,1998-11-01
852,旭区,100792,48698,52094,44226,1998-11-01
853,城東区,157339,75970,81369,66942,1998-11-01
854,阿倍野区,103093,48016,55077,44536,1998-11-01
855,東成区,78675,37750,40925,33803,1998-11-01
856,住吉区,161843,77104,84739,71402,1998-11-01
857,東住吉区,140511,67105,73406,59678,1998-11-01
858,平野区,201758,97769,103989,79640,1998-11-01
859,西成区,138606,78869,59737,74670,1998-11-01
860,住之江区,137652,66914,70738,53919,1998-11-01
861,東淀川区,185109,92656,92453,87277,1998-11-01
862,中央区,53425,24686,28739,27285,1998-11-01
863,西淀川区,91635,45761,45874,37580,1998-11-01
864,大阪市,2596625,1273374,1323251,1142403,1998-11-01
865,北区,88926,42779,46147,43697,1998-11-01
866,都島区,97384,47772,49612,42497,1998-11-01
867,福島区,55057,26294,28763,24155,1998-11-01
868,此花区,66168,32928,33240,27115,1998-11-01
869,淀川区,161601,80717,80884,77109,1998-11-01
870,西区,60191,28689,31502,27889,1998-11-01
871,港区,88446,43864,44582,37691,1998-11-01
872,大正区,76249,38101,38148,30744,1998-11-01
873,天王寺区,56626,26465,30161,25175,1998-11-01
874,浪速区,49991,25775,24216,28317,1998-11-01
875,東成区,78651,37740,40911,33790,1998-12-01
876,旭区,100731,48667,52064,44219,1998-12-01
877,城東区,157308,75946,81362,66973,1998-12-01
878,鶴見区,100241,49289,50952,37776,1998-12-01
879,阿倍野区,103126,48025,55101,44508,1998-12-01
880,住吉区,161802,77071,84731,71407,1998-12-01
881,東淀川区,185100,92639,92461,87354,1998-12-01
882,東住吉区,140368,67029,73339,59663,1998-12-01
883,平野区,201826,97791,104035,79694,1998-12-01
884,西成区,138452,78806,59646,74435,1998-12-01
885,住之江区,137610,66891,70719,53935,1998-12-01
886,淀川区,161533,80683,80850,77182,1998-12-01
887,生野区,145223,69355,75868,59319,1998-12-01
888,浪速区,49964,25771,24193,28345,1998-12-01
889,西淀川区,91687,45786,45901,37641,1998-12-01
890,北区,88859,42756,46103,43742,1998-12-01
891,都島区,97226,47695,49531,42463,1998-12-01
892,福島区,55041,26283,28758,24183,1998-12-01
893,此花区,66079,32875,33204,27107,1998-12-01
894,大阪市,2595663,1272850,1322813,1142674,1998-12-01
895,西区,60231,28704,31527,27951,1998-12-01
896,港区,88439,43854,44585,37736,1998-12-01
897,大正区,76198,38072,38126,30765,1998-12-01
898,天王寺区,56590,26454,30136,25164,1998-12-01
899,中央区,53378,24668,28710,27322,1998-12-01
900,東成区,78648,37740,40908,33799,1999-01-01
901,旭区,100728,48664,52064,44180,1999-01-01
902,城東区,157297,75932,81365,66988,1999-01-01
903,鶴見区,100221,49274,50947,37799,1999-01-01
904,阿倍野区,103216,48060,55156,44553,1999-01-01
905,住吉区,161843,77077,84766,71463,1999-01-01
906,東住吉区,140249,66965,73284,59641,1999-01-01
907,平野区,201933,97831,104102,79733,1999-01-01
908,西成区,138373,78786,59587,74440,1999-01-01
909,東淀川区,185030,92591,92439,87301,1999-01-01
910,住之江区,137601,66883,70718,53970,1999-01-01
911,淀川区,161549,80692,80857,77242,1999-01-01
912,生野区,145147,69315,75832,59246,1999-01-01
913,浪速区,49923,25760,24163,28322,1999-01-01
914,北区,88865,42767,46098,43762,1999-01-01
915,都島区,97055,47612,49443,42414,1999-01-01
916,福島区,54981,26250,28731,24155,1999-01-01
917,此花区,66198,32926,33272,27155,1999-01-01
918,中央区,53478,24717,28761,27389,1999-01-01
919,大阪市,2595381,1272653,1322728,1142824,1999-01-01
920,港区,88332,43794,44538,37706,1999-01-01
921,西区,60194,28683,31511,27946,1999-01-01
922,天王寺区,56621,26474,30147,25199,1999-01-01
923,西淀川区,91721,45802,45919,37643,1999-01-01
924,大正区,76178,38058,38120,30778,1999-01-01
925,東淀川区,184967,92547,92420,87288,1999-02-01
926,平野区,201997,97851,104146,79803,1999-02-01
927,東住吉区,140164,66918,73246,59620,1999-02-01
928,住吉区,161665,76979,84686,71366,1999-02-01
929,阿倍野区,103138,48016,55122,44550,1999-02-01
930,鶴見区,100348,49331,51017,37849,1999-02-01
931,城東区,157254,75903,81351,66977,1999-02-01
932,旭区,100579,48591,51988,44101,1999-02-01
933,生野区,144975,69230,75745,59211,1999-02-01
934,東成区,78575,37706,40869,33773,1999-02-01
935,西成区,138099,78655,59444,74338,1999-02-01
936,住之江区,137471,66817,70654,53931,1999-02-01
937,淀川区,161506,80670,80836,77184,1999-02-01
938,浪速区,49861,25738,24123,28351,1999-02-01
939,西淀川区,91723,45802,45921,37562,1999-02-01
940,大阪市,2594168,1271996,1322172,1142623,1999-02-01
941,北区,88973,42828,46145,43896,1999-02-01
942,福島区,54920,26217,28703,24138,1999-02-01
943,此花区,66076,32857,33219,27104,1999-02-01
944,都島区,97005,47588,49417,42422,1999-02-01
945,西区,60359,28759,31600,28084,1999-02-01
946,港区,88299,43771,44528,37629,1999-02-01
947,大正区,76079,38005,38074,30753,1999-02-01
948,天王寺区,56672,26504,30168,25243,1999-02-01
949,中央区,53463,24713,28750,27450,1999-02-01
950,鶴見区,100383,49343,51040,37893,1999-03-01
951,東成区,78574,37707,40867,33803,1999-03-01
952,旭区,100478,48541,51937,44077,1999-03-01
953,城東区,157157,75848,81309,66922,1999-03-01
954,阿倍野区,103095,47989,55106,44538,1999-03-01
955,東淀川区,184876,92489,92387,87254,1999-03-01
956,住吉区,161600,76935,84665,71310,1999-03-01
957,東住吉区,140075,66868,73207,59589,1999-03-01
958,平野区,202079,97879,104200,79868,1999-03-01
959,西成区,137941,78590,59351,74354,1999-03-01
960,住之江区,137290,66726,70564,53904,1999-03-01
961,淀川区,161411,80623,80788,77242,1999-03-01
962,生野区,144936,69208,75728,59218,1999-03-01
963,浪速区,49798,25715,24083,28419,1999-03-01
964,大阪市,2593408,1271560,1321848,1142970,1999-03-01
965,北区,89133,42914,46219,44093,1999-03-01
966,都島区,96954,47564,49390,42378,1999-03-01
967,福島区,54892,26200,28692,24108,1999-03-01
968,此花区,65961,32792,33169,27058,1999-03-01
969,西淀川区,91711,45794,45917,37578,1999-03-01
970,西区,60626,28882,31744,28271,1999-03-01
971,港区,88267,43748,44519,37618,1999-03-01
972,大正区,75999,37961,38038,30682,1999-03-01
973,天王寺区,56756,26549,30207,25345,1999-03-01
974,中央区,53416,24695,28721,27448,1999-03-01
975,西成区,137885,78583,59302,74445,1999-04-01
976,平野区,201986,97822,104164,79981,1999-04-01
977,東住吉区,139919,66786,73133,59611,1999-04-01
978,住吉区,161254,76757,84497,71307,1999-04-01
979,住之江区,136611,66392,70219,53820,1999-04-01
980,阿倍野区,103122,47995,55127,44575,1999-04-01
981,鶴見区,100499,49395,51104,38007,1999-04-01
982,城東区,156816,75675,81141,66993,1999-04-01
983,旭区,100400,48502,51898,44165,1999-04-01
984,東成区,78432,37641,40791,33846,1999-04-01
985,東淀川区,184337,92206,92131,87191,1999-04-01
986,生野区,144826,69152,75674,59253,1999-04-01
987,淀川区,161519,80678,80841,77666,1999-04-01
988,西淀川区,91613,45744,45869,37635,1999-04-01
989,大阪市,2591823,1270727,1321096,1145191,1999-04-01
990,北区,89519,43109,46410,44441,1999-04-01
991,都島区,97061,47617,49444,42538,1999-04-01
992,此花区,65704,32656,33048,26939,1999-04-01
993,福島区,55020,26257,28763,24249,1999-04-01
994,西区,61040,29076,31964,28556,1999-04-01
995,港区,88123,43670,44453,37675,1999-04-01
996,大正区,76031,37974,38057,30778,1999-04-01
997,天王寺区,56813,26581,30232,25429,1999-04-01
998,浪速区,49792,25722,24070,28513,1999-04-01
999,中央区,53501,24737,28764,27578,1999-04-01
1000,城東区,156907,75710,81197,67147,1999-05-01
1001,東成区,78546,37697,40849,33917,1999-05-01
1002,生野区,144799,69136,75663,59355,1999-05-01
1003,旭区,100436,48519,51917,44400,1999-05-01
1004,鶴見区,100607,49443,51164,38131,1999-05-01
1005,東淀川区,184817,92434,92383,87691,1999-05-01
1006,住之江区,136580,66374,70206,53959,1999-05-01
1007,住吉区,161311,76770,84541,71498,1999-05-01
1008,東住吉区,140012,66824,73188,59741,1999-05-01
1009,平野区,202041,97838,104203,80148,1999-05-01
1010,阿倍野区,103371,48104,55267,44801,1999-05-01
1011,西成区,137966,78654,59312,74703,1999-05-01
1012,淀川区,161865,80851,81014,78113,1999-05-01
1013,浪速区,49923,25799,24124,28682,1999-05-01
1014,大阪市,2595492,1272466,1323026,1150053,1999-05-01
1015,北区,89890,43296,46594,44903,1999-05-01
1016,都島区,97573,47869,49704,42859,1999-05-01
1017,福島区,55216,26347,28869,24473,1999-05-01
1018,此花区,65719,32655,33064,27017,1999-05-01
1019,西淀川区,91707,45790,45917,37820,1999-05-01
1020,西区,61339,29215,32124,28696,1999-05-01
1021,港区,88041,43622,44419,37680,1999-05-01
1022,大正区,75955,37932,38023,30837,1999-05-01
1023,天王寺区,57155,26747,30408,25672,1999-05-01
1024,中央区,53716,24840,28876,27810,1999-05-01
1025,東成区,78506,37679,40827,33937,1999-06-01
1026,生野区,144677,69075,75602,59357,1999-06-01
1027,旭区,100345,48474,51871,44384,1999-06-01
1028,城東区,156897,75697,81200,67168,1999-06-01
1029,鶴見区,100603,49436,51167,38185,1999-06-01
1030,住之江区,136553,66358,70195,53972,1999-06-01
1031,住吉区,161325,76764,84561,71566,1999-06-01
1032,東住吉区,140061,66840,73221,59822,1999-06-01
1033,平野区,202061,97836,104225,80210,1999-06-01
1034,東淀川区,184923,92474,92449,87782,1999-06-01
1035,阿倍野区,103319,48073,55246,44812,1999-06-01
1036,西成区,137914,78649,59265,74777,1999-06-01
1037,淀川区,161878,80857,81021,78242,1999-06-01
1038,浪速区,49889,25792,24097,28710,1999-06-01
1039,西淀川区,91786,45828,45958,37903,1999-06-01
1040,大阪市,2595746,1272537,1323209,1151265,1999-06-01
1041,北区,90137,43424,46713,45093,1999-06-01
1042,福島区,55229,26349,28880,24502,1999-06-01
1043,此花区,65648,32612,33036,26991,1999-06-01
1044,都島区,97625,47895,49730,42916,1999-06-01
1045,西区,61563,29318,32245,28826,1999-06-01
1046,港区,87961,43576,44385,37665,1999-06-01
1047,大正区,75875,37888,37987,30835,1999-06-01
1048,天王寺区,57152,26752,30400,25713,1999-06-01
1049,中央区,53819,24891,28928,27897,1999-06-01
1050,城東区,156861,75671,81190,67188,1999-07-01
1051,東成区,78473,37665,40808,33957,1999-07-01
1052,生野区,144505,68989,75516,59358,1999-07-01
1053,旭区,100267,48435,51832,44378,1999-07-01
1054,鶴見区,100722,49489,51233,38240,1999-07-01
1055,東淀川区,184951,92475,92476,87845,1999-07-01
1056,住之江区,136451,66305,70146,53947,1999-07-01
1057,住吉区,161298,76738,84560,71610,1999-07-01
1058,東住吉区,140025,66816,73209,59848,1999-07-01
1059,平野区,202063,97825,104238,80233,1999-07-01
1060,阿倍野区,103241,48030,55211,44790,1999-07-01
1061,淀川区,161929,80883,81046,78349,1999-07-01
1062,西成区,137846,78635,59211,74777,1999-07-01
1063,浪速区,49873,25793,24080,28787,1999-07-01
1064,大阪市,2595545,1272387,1323158,1152150,1999-07-01
1065,北区,90230,43478,46752,45239,1999-07-01
1066,都島区,97646,47906,49740,42950,1999-07-01
1067,福島区,55225,26343,28882,24531,1999-07-01
1068,此花区,65578,32569,33009,26965,1999-07-01
1069,西淀川区,91813,45840,45973,37966,1999-07-01
1070,西区,61696,29378,32318,28924,1999-07-01
1071,港区,87960,43569,44391,37696,1999-07-01
1072,大正区,75816,37855,37961,30830,1999-07-01
1073,天王寺区,57213,26786,30427,25771,1999-07-01
1074,中央区,53863,24914,28949,27971,1999-07-01
1075,生野区,144335,68905,75430,59319,1999-08-01
1076,旭区,100266,48433,51833,44406,1999-08-01
1077,城東区,156833,75649,81184,67241,1999-08-01
1078,鶴見区,100786,49516,51270,38276,1999-08-01
1079,阿倍野区,103192,48000,55192,44813,1999-08-01
1080,住吉区,161306,76728,84578,71628,1999-08-01
1081,東住吉区,139930,66763,73167,59850,1999-08-01
1082,平野区,202097,97830,104267,80280,1999-08-01
1083,西成区,137689,78570,59119,74753,1999-08-01
1084,東成区,78569,37712,40857,33960,1999-08-01
1085,住之江区,136401,66278,70123,53985,1999-08-01
1086,東淀川区,184917,92445,92472,87836,1999-08-01
1087,福島区,55209,26332,28877,24542,1999-08-01
1088,西淀川区,91723,45794,45929,37968,1999-08-01
1089,北区,90270,43506,46764,45370,1999-08-01
1090,都島区,97595,47882,49713,42974,1999-08-01
1091,淀川区,161997,80918,81079,78460,1999-08-01
1092,此花区,65618,32581,33037,27020,1999-08-01
1093,中央区,53958,24961,28997,28052,1999-08-01
1094,大阪市,2595523,1272313,1323210,1153011,1999-08-01
1095,港区,87969,43566,44403,37743,1999-08-01
1096,大正区,75782,37835,37947,30833,1999-08-01
1097,天王寺区,57413,26886,30527,25874,1999-08-01
1098,浪速区,49832,25782,24050,28797,1999-08-01
1099,西区,61836,29441,32395,29031,1999-08-01
1100,東成区,78575,37717,40858,33973,1999-09-01
1101,生野区,144165,68821,75344,59318,1999-09-01
1102,旭区,100165,48383,51782,44420,1999-09-01
1103,城東区,156789,75620,81169,67215,1999-09-01
1104,鶴見区,101054,49642,51412,38378,1999-09-01
1105,住之江区,136158,66156,70002,53954,1999-09-01
1106,住吉区,161297,76711,84586,71654,1999-09-01
1107,東住吉区,139810,66699,73111,59826,1999-09-01
1108,平野区,202107,97824,104283,80318,1999-09-01
1109,東淀川区,184832,92390,92442,87855,1999-09-01
1110,阿倍野区,103164,47980,55184,44794,1999-09-01
1111,淀川区,162016,80927,81089,78527,1999-09-01
1112,西成区,137615,78553,59062,74756,1999-09-01
1113,浪速区,49896,25825,24071,28861,1999-09-01
1114,大阪市,2595552,1272276,1323276,1153820,1999-09-01
1115,北区,90564,43656,46908,45570,1999-09-01
1116,都島区,97531,47851,49680,42948,1999-09-01
1117,福島区,55235,26340,28895,24555,1999-09-01
1118,此花区,65760,32643,33117,27158,1999-09-01
1119,西淀川区,91710,45786,45924,37995,1999-09-01
1120,西区,61916,29476,32440,29103,1999-09-01
1121,港区,87853,43502,44351,37712,1999-09-01
1122,大正区,75795,37837,37958,30861,1999-09-01
1123,天王寺区,57516,26940,30576,25927,1999-09-01
1124,中央区,54029,24997,29032,28142,1999-09-01
1125,東成区,78600,37730,40870,34001,1999-10-01
1126,生野区,144051,68763,75288,59318,1999-10-01
1127,旭区,100094,48348,51746,44414,1999-10-01
1128,城東区,156710,75573,81137,67208,1999-10-01
1129,鶴見区,101081,49650,51431,38396,1999-10-01
1130,住之江区,136072,66111,69961,53952,1999-10-01
1131,住吉区,161221,76661,84560,71639,1999-10-01
1132,東住吉区,139801,66687,73114,59852,1999-10-01
1133,平野区,202077,97798,104279,80356,1999-10-01
1134,東淀川区,184742,92332,92410,87835,1999-10-01
1135,阿倍野区,103184,47983,55201,44809,1999-10-01
1136,西成区,137506,78515,58991,74799,1999-10-01
1137,淀川区,162073,80956,81117,78649,1999-10-01
1138,浪速区,49921,25847,24074,28914,1999-10-01
1139,西淀川区,91714,45787,45927,38036,1999-10-01
1140,大阪市,2595155,1272025,1323130,1154482,1999-10-01
1141,北区,90638,43701,46937,45635,1999-10-01
1142,福島区,55228,26333,28895,24556,1999-10-01
1143,此花区,65750,32630,33120,27191,1999-10-01
1144,都島区,97502,47838,49664,42961,1999-10-01
1145,西区,62009,29517,32492,29176,1999-10-01
1146,港区,87709,43424,44285,37693,1999-10-01
1147,大正区,75785,37829,37956,30881,1999-10-01
1148,天王寺区,57624,26996,30628,26013,1999-10-01
1149,中央区,54063,25016,29047,28198,1999-10-01
1150,城東区,157124,75764,81360,67468,1999-11-01
1151,東成区,78611,37737,40874,34011,1999-11-01
1152,生野区,143955,68714,75241,59336,1999-11-01
1153,旭区,100009,48305,51704,44348,1999-11-01
1154,鶴見区,101110,49659,51451,38442,1999-11-01
1155,東淀川区,184599,92248,92351,87803,1999-11-01
1156,住之江区,135911,66030,69881,53939,1999-11-01
1157,住吉区,161146,76612,84534,71640,1999-11-01
1158,東住吉区,139886,66721,73165,59901,1999-11-01
1159,平野区,202027,97762,104265,80383,1999-11-01
1160,阿倍野区,103275,48018,55257,44866,1999-11-01
1161,淀川区,162139,80989,81150,78738,1999-11-01
1162,西成区,137414,78487,58927,74780,1999-11-01
1163,浪速区,49931,25862,24069,28956,1999-11-01
1164,大阪市,2595155,1271957,1323198,1155197,1999-11-01
1165,北区,90639,43710,46929,45676,1999-11-01
1166,都島区,97401,47789,49612,42933,1999-11-01
1167,福島区,55248,26339,28909,24583,1999-11-01
1168,此花区,65698,32596,33102,27203,1999-11-01
1169,西淀川区,91637,45747,45890,38023,1999-11-01
1170,西区,62123,29568,32555,29258,1999-11-01
1171,港区,87633,43379,44254,37704,1999-11-01
1172,大正区,75693,37779,37914,30876,1999-11-01
1173,天王寺区,57776,27073,30703,26098,1999-11-01
1174,中央区,54170,25069,29101,28232,1999-11-01
1175,生野区,143799,68637,75162,59350,1999-12-01
1176,旭区,99950,48276,51674,44352,1999-12-01
1177,城東区,157129,75758,81371,67486,1999-12-01
1178,鶴見区,101193,49695,51498,38477,1999-12-01
1179,阿倍野区,103342,48042,55300,44960,1999-12-01
1180,住吉区,161153,76602,84551,71659,1999-12-01
1181,東住吉区,139998,66767,73231,59994,1999-12-01
1182,平野区,201925,97701,104224,80417,1999-12-01
1183,西成区,137332,78465,58867,74747,1999-12-01
1184,東成区,78684,37773,40911,34045,1999-12-01
1185,住之江区,135993,66067,69926,54039,1999-12-01
1186,東淀川区,184552,92212,92340,87831,1999-12-01
1187,淀川区,162154,80997,81157,78824,1999-12-01
1188,西淀川区,91602,45729,45873,38047,1999-12-01
1189,北区,90781,43788,46993,45818,1999-12-01
1190,都島区,97362,47771,49591,42919,1999-12-01
1191,福島区,55355,26386,28969,24636,1999-12-01
1192,此花区,65614,32546,33068,27180,1999-12-01
1193,中央区,54177,25075,29102,28233,1999-12-01
1194,大阪市,2595428,1272032,1323396,1156074,1999-12-01
1195,港区,87574,43343,44231,37748,1999-12-01
1196,大正区,75678,37768,37910,30902,1999-12-01
1197,天王寺区,57848,27113,30735,26181,1999-12-01
1198,浪速区,49925,25869,24056,28855,1999-12-01
1199,西区,62308,29652,32656,29374,1999-12-01
1200,東成区,78726,37795,40931,34072,2000-01-01
1201,生野区,143721,68596,75125,59352,2000-01-01
1202,旭区,99909,48255,51654,44348,2000-01-01
1203,城東区,157097,75734,81363,67442,2000-01-01
1204,鶴見区,101256,49720,51536,38506,2000-01-01
1205,住之江区,135972,66053,69919,54118,2000-01-01
1206,住吉区,161233,76627,84606,71684,2000-01-01
1207,東住吉区,140010,66766,73244,60012,2000-01-01
1208,平野区,201849,97653,104196,80384,2000-01-01
1209,東淀川区,184377,92112,92265,87749,2000-01-01
1210,阿倍野区,103279,48006,55273,44950,2000-01-01
1211,淀川区,162133,80987,81146,78721,2000-01-01
1212,西成区,137228,78430,58798,74744,2000-01-01
1213,浪速区,49967,25901,24066,28932,2000-01-01
1214,大阪市,2595224,1271875,1323349,1156299,2000-01-01
1215,北区,90849,43830,47019,45940,2000-01-01
1216,都島区,97310,47746,49564,42937,2000-01-01
1217,福島区,55373,26391,28982,24644,2000-01-01
1218,此花区,65519,32491,33028,27126,2000-01-01
1219,西淀川区,91683,45768,45915,38078,2000-01-01
1220,西区,62391,29688,32703,29427,2000-01-01
1221,港区,87539,43319,44220,37777,2000-01-01
1222,大正区,75621,37736,37885,30879,2000-01-01
1223,天王寺区,57946,27165,30781,26197,2000-01-01
1224,中央区,54236,25106,29130,28280,2000-01-01
1225,東成区,78743,37805,40938,34077,2000-02-01
1226,平野区,201849,97642,104207,80382,2000-02-01
1227,東住吉区,139930,66720,73210,60011,2000-02-01
1228,住吉区,161157,76577,84580,71645,2000-02-01
1229,住之江区,135932,66031,69901,54107,2000-02-01
1230,阿倍野区,103300,48009,55291,44964,2000-02-01
1231,鶴見区,101205,49690,51515,38506,2000-02-01
1232,城東区,157021,75689,81332,67429,2000-02-01
1233,旭区,99882,48241,51641,44323,2000-02-01
1234,生野区,143527,68500,75027,59278,2000-02-01
1235,東淀川区,184186,92003,92183,87663,2000-02-01
1236,西成区,137009,78330,58679,74701,2000-02-01
1237,淀川区,162478,81160,81318,78945,2000-02-01
1238,大阪市,2594508,1271465,1323043,1156354,2000-02-01
1239,北区,90885,43856,47029,46044,2000-02-01
1240,都島区,97230,47708,49522,42873,2000-02-01
1241,福島区,55332,26367,28965,24612,2000-02-01
1242,此花区,65459,32453,33006,27099,2000-02-01
1243,西淀川区,91640,45745,45895,38072,2000-02-01
1244,西区,62494,29734,32760,29504,2000-02-01
1245,港区,87485,43286,44199,37721,2000-02-01
1246,大正区,75528,37686,37842,30878,2000-02-01
1247,天王寺区,58008,27200,30808,26239,2000-02-01
1248,浪速区,49991,25923,24068,28978,2000-02-01
1249,中央区,54237,25110,29127,28303,2000-02-01
1250,東成区,78729,37799,40930,34064,2000-03-01
1251,生野区,143362,68418,74944,59272,2000-03-01
1252,旭区,99760,48181,51579,44304,2000-03-01
1253,城東区,156989,75665,81324,67450,2000-03-01
1254,鶴見区,101234,49699,51535,38512,2000-03-01
1255,住吉区,161082,76529,84553,71640,2000-03-01
1256,住之江区,135834,65980,69854,54120,2000-03-01
1257,東住吉区,139909,66703,73206,60055,2000-03-01
1258,平野区,201810,97612,104198,80413,2000-03-01
1259,東淀川区,184049,91922,92127,87670,2000-03-01
1260,阿倍野区,103268,47987,55281,44962,2000-03-01
1261,西成区,136866,78273,58593,74725,2000-03-01
1262,西淀川区,91883,45865,46018,38194,2000-03-01
1263,浪速区,49969,25921,24048,29028,2000-03-01
1264,淀川区,162544,81193,81351,79049,2000-03-01
1265,大阪市,2593851,1271087,1322764,1156867,2000-03-01
1266,北区,90935,43889,47046,46139,2000-03-01
1267,福島区,55293,26345,28948,24620,2000-03-01
1268,此花区,65372,32402,32970,27066,2000-03-01
1269,都島区,97237,47712,49525,42881,2000-03-01
1270,西区,62560,29761,32799,29555,2000-03-01
1271,港区,87392,43233,44159,37693,2000-03-01
1272,大正区,75439,37638,37801,30823,2000-03-01
1273,天王寺区,58039,27220,30819,26249,2000-03-01
1274,中央区,54296,25140,29156,28383,2000-03-01
1275,城東区,157585,75944,81641,67854,2000-04-01
1276,東成区,78683,37779,40904,34145,2000-04-01
1277,生野区,143064,68273,74791,59258,2000-04-01
1278,旭区,99527,48067,51460,44297,2000-04-01
1279,鶴見区,101291,49722,51569,38645,2000-04-01
1280,東淀川区,183634,91702,91932,87837,2000-04-01
1281,住之江区,135448,65789,69659,54102,2000-04-01
1282,住吉区,160761,76363,84398,71670,2000-04-01
1283,東住吉区,139766,66628,73138,60127,2000-04-01
1284,平野区,201281,97344,103937,80295,2000-04-01
1285,阿倍野区,103206,47951,55255,44946,2000-04-01
1286,西成区,136938,78339,58599,74743,2000-04-01
1287,淀川区,162677,81260,81417,79444,2000-04-01
1288,浪速区,50036,25966,24070,29081,2000-04-01
1289,大阪市,2592744,1270501,1322243,1158944,2000-04-01
1290,北区,91120,43987,47133,46398,2000-04-01
1291,都島区,97073,47632,49441,42868,2000-04-01
1292,福島区,55236,26314,28922,24657,2000-04-01
1293,此花区,65209,32313,32896,27071,2000-04-01
1294,西淀川区,91976,45910,46066,38255,2000-04-01
1295,西区,62771,29858,32913,29730,2000-04-01
1296,港区,87260,43161,44099,37788,2000-04-01
1297,大正区,75304,37567,37737,30838,2000-04-01
1298,天王寺区,58361,27377,30984,26432,2000-04-01
1299,中央区,54537,25255,29282,28463,2000-04-01
1300,生野区,143142,68307,74835,59448,2000-05-01
1301,旭区,99535,48070,51465,44424,2000-05-01
1302,城東区,157871,76073,81798,68131,2000-05-01
1303,鶴見区,101492,49815,51677,38780,2000-05-01
1304,阿倍野区,103515,48088,55427,45215,2000-05-01
1305,住吉区,161061,76492,84569,72015,2000-05-01
1306,東住吉区,139993,66729,73264,60341,2000-05-01
1307,平野区,201363,97373,103990,80432,2000-05-01
1308,西成区,136879,78330,58549,74834,2000-05-01
1309,東成区,78796,37834,40962,34236,2000-05-01
1310,住之江区,135468,65796,69672,54212,2000-05-01
1311,東淀川区,184014,91879,92135,88290,2000-05-01
1312,淀川区,163204,81523,81681,79987,2000-05-01
1313,西淀川区,92027,45935,46092,38332,2000-05-01
1314,北区,91565,44211,47354,46813,2000-05-01
1315,都島区,97243,47716,49527,43066,2000-05-01
1316,福島区,55409,26392,29017,24854,2000-05-01
1317,此花区,65335,32367,32968,27211,2000-05-01
1318,中央区,54834,25396,29438,28830,2000-05-01
1319,大阪市,2597267,1272635,1324632,1164215,2000-05-01
1320,港区,87426,43236,44190,37892,2000-05-01
1321,大正区,75208,37515,37693,30874,2000-05-01
1322,天王寺区,58615,27502,31113,26688,2000-05-01
1323,浪速区,50123,26021,24102,29271,2000-05-01
1324,西区,63149,30035,33114,30039,2000-05-01
1325,生野区,143129,68298,74831,59511,2000-06-01
1326,旭区,99467,48036,51431,44413,2000-06-01
1327,城東区,157978,76116,81862,68245,2000-06-01
1328,鶴見区,101613,49869,51744,38873,2000-06-01
1329,阿倍野区,103770,48200,55570,45376,2000-06-01
1330,住吉区,161032,76465,84567,72086,2000-06-01
1331,東住吉区,139954,66703,73251,60381,2000-06-01
1332,平野区,201568,97460,104108,80560,2000-06-01
1333,西成区,136790,78303,58487,74895,2000-06-01
1334,東成区,78721,37800,40921,34255,2000-06-01
1335,住之江区,135466,65792,69674,54262,2000-06-01
1336,東淀川区,184048,91884,92164,88405,2000-06-01
1337,淀川区,163426,81635,81791,80202,2000-06-01
1338,西淀川区,92096,45968,46128,38414,2000-06-01
1339,北区,91764,44316,47448,46990,2000-06-01
1340,都島区,97261,47726,49535,43125,2000-06-01
1341,福島区,55595,26477,29118,24993,2000-06-01
1342,此花区,65262,32323,32939,27199,2000-06-01
1343,中央区,54991,25472,29519,28925,2000-06-01
1344,大阪市,2598565,1273210,1325355,1166110,2000-06-01
1345,港区,87411,43222,44189,37924,2000-06-01
1346,大正区,75134,37474,37660,30864,2000-06-01
1347,天王寺区,58628,27515,31113,26735,2000-06-01
1348,浪速区,50225,26084,24141,29350,2000-06-01
1349,西区,63236,30072,33164,30127,2000-06-01
1350,生野区,143120,68290,74830,59576,2000-07-01
1351,旭区,99411,48007,51404,44427,2000-07-01
1352,城東区,158023,76129,81894,68284,2000-07-01
1353,鶴見区,101653,49884,51769,38910,2000-07-01
1354,阿倍野区,103837,48224,55613,45421,2000-07-01
1355,住吉区,161068,76469,84599,72109,2000-07-01
1356,東住吉区,139818,66632,73186,60309,2000-07-01
1357,平野区,201582,97456,104126,80630,2000-07-01
1358,西成区,136840,78357,58483,75092,2000-07-01
1359,東成区,78726,37804,40922,34248,2000-07-01
1360,住之江区,135438,65775,69663,54299,2000-07-01
1361,東淀川区,184021,91857,92164,88436,2000-07-01
1362,淀川区,163619,81731,81888,80367,2000-07-01
1363,西淀川区,92119,45978,46141,38424,2000-07-01
1364,北区,91831,44357,47474,47107,2000-07-01
1365,都島区,97282,47737,49545,43162,2000-07-01
1366,福島区,55719,26532,29187,25079,2000-07-01
1367,此花区,65188,32278,32910,27176,2000-07-01
1368,中央区,54981,25470,29511,28932,2000-07-01
1369,大阪市,2598958,1273355,1325603,1167192,2000-07-01
1370,港区,87410,43215,44195,37919,2000-07-01
1371,大正区,75092,37450,37642,30880,2000-07-01
1372,天王寺区,58688,27549,31139,26798,2000-07-01
1373,浪速区,50154,26057,24097,29413,2000-07-01
1374,西区,63338,30117,33221,30194,2000-07-01
1375,生野区,143038,68248,74790,59613,2000-08-01
1376,旭区,99227,47917,51310,44369,2000-08-01
1377,城東区,157959,76090,81869,68302,2000-08-01
1378,鶴見区,101748,49925,51823,38964,2000-08-01
1379,阿倍野区,103805,48202,55603,45453,2000-08-01
1380,住吉区,161031,76438,84593,72151,2000-08-01
1381,東住吉区,139691,66564,73127,60303,2000-08-01
1382,平野区,201628,97466,104162,80724,2000-08-01
1383,西成区,136730,78318,58412,75107,2000-08-01
1384,東成区,78712,37798,40914,34265,2000-08-01
1385,住之江区,135364,65736,69628,54311,2000-08-01
1386,東淀川区,184128,91898,92230,88549,2000-08-01
1387,淀川区,163520,81682,81838,80383,2000-08-01
1388,西淀川区,92106,45970,46136,38424,2000-08-01
1389,北区,91847,44374,47473,47165,2000-08-01
1390,都島区,97352,47772,49580,43217,2000-08-01
1391,福島区,55682,26511,29171,25079,2000-08-01
1392,此花区,65131,32242,32889,27177,2000-08-01
1393,中央区,55065,25512,29553,29004,2000-08-01
1394,大阪市,2598694,1273172,1325522,1167962,2000-08-01
1395,港区,87454,43229,44225,37939,2000-08-01
1396,大正区,75106,37453,37653,30909,2000-08-01
1397,天王寺区,58760,27589,31171,26830,2000-08-01
1398,浪速区,50189,26085,24104,29447,2000-08-01
1399,西区,63421,30153,33268,30277,2000-08-01
1400,生野区,142928,68192,74736,59608,2000-09-01
1401,旭区,99161,47884,51277,44366,2000-09-01
1402,城東区,157964,76084,81880,68361,2000-09-01
1403,鶴見区,101793,49942,51851,38976,2000-09-01
1404,阿倍野区,103923,48250,55673,45531,2000-09-01
1405,住吉区,161154,76483,84671,72216,2000-09-01
1406,東住吉区,139700,66561,73139,60345,2000-09-01
1407,平野区,201659,97470,104189,80789,2000-09-01
1408,西成区,136779,78371,58408,75178,2000-09-01
1409,東成区,78636,37763,40873,34274,2000-09-01
1410,住之江区,135406,65753,69653,54297,2000-09-01
1411,東淀川区,184069,91856,92213,88522,2000-09-01
1412,淀川区,163391,81618,81773,80342,2000-09-01
1413,西淀川区,92172,46002,46170,38467,2000-09-01
1414,北区,91879,44399,47480,47299,2000-09-01
1415,都島区,97286,47740,49546,43206,2000-09-01
1416,福島区,55716,26523,29193,25114,2000-09-01
1417,此花区,65143,32240,32903,27165,2000-09-01
1418,中央区,55239,25596,29643,29150,2000-09-01
1419,大阪市,2598810,1273179,1325631,1168738,2000-09-01
1420,港区,87373,43183,44190,37949,2000-09-01
1421,大正区,75057,37425,37632,30928,2000-09-01
1422,天王寺区,58797,27612,31185,26857,2000-09-01
1423,浪速区,50198,26099,24099,29518,2000-09-01
1424,西区,63387,30133,33254,30280,2000-09-01
1425,生野区,142743,68101,74642,59619,2000-10-01
1426,旭区,99231,47917,51314,44426,2000-10-01
1427,城東区,157936,76062,81874,68416,2000-10-01
1428,鶴見区,101971,50024,51947,39066,2000-10-01
1429,阿倍野区,103973,48266,55707,45596,2000-10-01
1430,住吉区,161047,76419,84628,72234,2000-10-01
1431,東住吉区,139593,66503,73090,60336,2000-10-01
1432,平野区,201722,97489,104233,80874,2000-10-01
1433,西成区,136813,78415,58398,75266,2000-10-01
1434,東成区,78580,37738,40842,34254,2000-10-01
1435,住之江区,135437,65765,69672,54303,2000-10-01
1436,東淀川区,183888,91753,92135,88480,2000-10-01
1437,淀川区,163370,81608,81762,80410,2000-10-01
1438,西淀川区,92465,46147,46318,38609,2000-10-01
1439,北区,91952,44443,47509,47386,2000-10-01
1440,都島区,97253,47725,49528,43223,2000-10-01
1441,福島区,55733,26527,29206,25136,2000-10-01
1442,此花区,65037,32179,32858,27128,2000-10-01
1443,中央区,55324,25639,29685,29205,2000-10-01
1444,大阪市,2598774,1273121,1325653,1169621,2000-10-01
1445,港区,87262,43121,44141,37925,2000-10-01
1446,大正区,75042,37414,37628,30943,2000-10-01
1447,天王寺区,58812,27625,31187,26890,2000-10-01
1448,浪速区,50188,26104,24084,29591,2000-10-01
1449,西区,63402,30137,33265,30305,2000-10-01
1450,生野区,142641,68053,74588,59669,2000-11-01
1451,旭区,99192,47890,51302,44381,2000-11-01
1452,城東区,157988,76079,81909,68472,2000-11-01
1453,鶴見区,101923,49989,51934,39047,2000-11-01
1454,阿倍野区,104119,48335,55784,45650,2000-11-01
1455,住吉区,161014,76393,84621,72223,2000-11-01
1456,東住吉区,139513,66460,73053,60296,2000-11-01
1457,平野区,201768,97492,104276,80933,2000-11-01
1458,西成区,136844,78466,58378,75340,2000-11-01
1459,東成区,78526,37706,40820,34234,2000-11-01
1460,住之江区,135378,65727,69651,54326,2000-11-01
1461,東淀川区,183781,91698,92083,88442,2000-11-01
1462,淀川区,163397,81608,81789,80473,2000-11-01
1463,西淀川区,92532,46174,46358,38657,2000-11-01
1464,北区,92006,44467,47539,47462,2000-11-01
1465,都島区,97369,47776,49593,43307,2000-11-01
1466,福島区,55819,26566,29253,25209,2000-11-01
1467,此花区,65019,32160,32859,27120,2000-11-01
1468,中央区,55432,25689,29743,29304,2000-11-01
1469,大阪市,2599173,1273204,1325969,1170467,2000-11-01
1470,港区,87151,43059,44092,37898,2000-11-01
1471,大正区,75036,37405,37631,30944,2000-11-01
1472,天王寺区,58873,27649,31224,26913,2000-11-01
1473,浪速区,50307,26158,24149,29693,2000-11-01
1474,西区,63545,30205,33340,30474,2000-11-01
1475,東成区,78683,37775,40908,34339,2000-12-01
1476,生野区,142453,67963,74490,59671,2000-12-01
1477,旭区,99134,47854,51280,44367,2000-12-01
1478,城東区,157906,76031,81875,68464,2000-12-01
1479,鶴見区,102065,50047,52018,39096,2000-12-01
1480,住之江区,135353,65705,69648,54312,2000-12-01
1481,住吉区,161031,76390,84641,72279,2000-12-01
1482,東住吉区,139433,66417,73016,60251,2000-12-01
1483,平野区,201919,97547,104372,81085,2000-12-01
1484,東淀川区,183637,91624,92013,88414,2000-12-01
1485,阿倍野区,104152,48351,55801,45659,2000-12-01
1486,淀川区,163335,81564,81771,80462,2000-12-01
1487,西成区,136822,78487,58335,75505,2000-12-01
1488,浪速区,50361,26179,24182,29772,2000-12-01
1489,大阪市,2599265,1273132,1326133,1171366,2000-12-01
1490,北区,92070,44497,47573,47514,2000-12-01
1491,都島区,97302,47737,49565,43313,2000-12-01
1492,福島区,55962,26632,29330,25282,2000-12-01
1493,此花区,64880,32082,32798,27085,2000-12-01
1494,西淀川区,92704,46253,46451,38713,2000-12-01
1495,西区,63765,30309,33456,30692,2000-12-01
1496,港区,87007,42981,44026,37871,2000-12-01
1497,大正区,74976,37369,37607,30928,2000-12-01
1498,天王寺区,58874,27645,31229,26911,2000-12-01
1499,中央区,55441,25693,29748,29381,2000-12-01
1500,生野区,142451,67962,74489,59684,2001-01-01
1501,旭区,99080,47821,51259,44343,2001-01-01
1502,城東区,157843,75992,81851,68361,2001-01-01
1503,鶴見区,102195,50100,52095,39141,2001-01-01
1504,阿倍野区,104156,48354,55802,45648,2001-01-01
1505,住吉区,161180,76450,84730,72339,2001-01-01
1506,東住吉区,139266,66332,72934,60252,2001-01-01
1507,平野区,201854,97497,104357,81138,2001-01-01
1508,西成区,136788,78501,58287,75338,2001-01-01
1509,東成区,78685,37770,40915,34343,2001-01-01
1510,住之江区,135147,65595,69552,54279,2001-01-01
1511,東淀川区,183502,91555,91947,88376,2001-01-01
1512,淀川区,163271,81519,81752,80270,2001-01-01
1513,西淀川区,92726,46258,46468,38738,2001-01-01
1514,北区,92105,44512,47593,47349,2001-01-01
1515,都島区,97327,47743,49584,43307,2001-01-01
1516,福島区,56091,26692,29399,25373,2001-01-01
1517,此花区,64881,32072,32809,27098,2001-01-01
1518,中央区,55505,25722,29783,29473,2001-01-01
1519,大阪市,2599115,1272942,1326173,1171244,2001-01-01
1520,港区,86930,42936,43994,37868,2001-01-01
1521,大正区,74906,37328,37578,30907,2001-01-01
1522,天王寺区,58926,27664,31262,26949,2001-01-01
1523,浪速区,50454,26220,24234,29860,2001-01-01
1524,西区,63846,30347,33499,30810,2001-01-01
1525,生野区,142388,67933,74455,59717,2001-02-01
1526,旭区,98954,47752,51202,44275,2001-02-01
1527,城東区,157749,75938,81811,68327,2001-02-01
1528,鶴見区,102597,50285,52312,39276,2001-02-01
1529,阿倍野区,104074,48317,55757,45610,2001-02-01
1530,住吉区,161030,76368,84662,72268,2001-02-01
1531,東住吉区,139100,66248,72852,60225,2001-02-01
1532,平野区,201785,97444,104341,81133,2001-02-01
1533,西成区,136725,78498,58227,75446,2001-02-01
1534,東成区,78624,37735,40889,34336,2001-02-01
1535,住之江区,135263,65642,69621,54338,2001-02-01
1536,東淀川区,183341,91473,91868,88287,2001-02-01
1537,淀川区,163270,81505,81765,80288,2001-02-01
1538,西淀川区,92689,46233,46456,38719,2001-02-01
1539,北区,92198,44555,47643,47422,2001-02-01
1540,都島区,97352,47750,49602,43315,2001-02-01
1541,福島区,56104,26696,29408,25390,2001-02-01
1542,此花区,64904,32074,32830,27110,2001-02-01
1543,中央区,55681,25804,29877,29648,2001-02-01
1544,大阪市,2598942,1272743,1326199,1171670,2001-02-01
1545,港区,87009,42969,44040,37869,2001-02-01
1546,大正区,74808,37273,37535,30850,2001-02-01
1547,天王寺区,58946,27669,31277,26988,2001-02-01
1548,浪速区,50421,26195,24226,29889,2001-02-01
1549,西区,63930,30387,33543,30944,2001-02-01
1550,生野区,142311,67896,74415,59742,2001-03-01
1551,旭区,98809,47674,51135,44219,2001-03-01
1552,城東区,157885,75995,81890,68401,2001-03-01
1553,鶴見区,102687,50318,52369,39313,2001-03-01
1554,阿倍野区,104201,48377,55824,45579,2001-03-01
1555,住吉区,160912,76301,84611,72209,2001-03-01
1556,東住吉区,139006,66198,72808,60197,2001-03-01
1557,平野区,201807,97436,104371,81142,2001-03-01
1558,西成区,136648,78487,58161,75541,2001-03-01
1559,東成区,78582,37709,40873,34342,2001-03-01
1560,住之江区,135205,65604,69601,54367,2001-03-01
1561,東淀川区,183201,91401,91800,88241,2001-03-01
1562,淀川区,163303,81509,81794,80322,2001-03-01
1563,西淀川区,92659,46211,46448,38729,2001-03-01
1564,北区,92266,44586,47680,47511,2001-03-01
1565,都島区,97401,47768,49633,43339,2001-03-01
1566,福島区,56115,26700,29415,25410,2001-03-01
1567,此花区,64914,32069,32845,27153,2001-03-01
1568,中央区,55744,25833,29911,29776,2001-03-01
1569,大阪市,2598864,1272586,1326278,1172259,2001-03-01
1570,港区,87000,42957,44043,37852,2001-03-01
1571,大正区,74779,37253,37526,30856,2001-03-01
1572,天王寺区,59019,27698,31321,27036,2001-03-01
1573,浪速区,50485,26221,24264,29950,2001-03-01
1574,西区,63925,30385,33540,31032,2001-03-01
1575,東成区,78670,37745,40925,34478,2001-04-01
1576,生野区,142078,67785,74293,59685,2001-04-01
1577,旭区,98706,47617,51089,44159,2001-04-01
1578,城東区,157699,75897,81802,68457,2001-04-01
1579,鶴見区,102727,50326,52401,39413,2001-04-01
1580,住之江区,134843,65419,69424,54346,2001-04-01
1581,住吉区,160808,76241,84567,72297,2001-04-01
1582,東住吉区,138758,66075,72683,60188,2001-04-01
1583,平野区,201601,97318,104283,81238,2001-04-01
1584,東淀川区,182846,91222,91624,88368,2001-04-01
1585,阿倍野区,104336,48441,55895,45633,2001-04-01
1586,淀川区,163455,81571,81884,80673,2001-04-01
1587,西成区,136632,78511,58121,75755,2001-04-01
1588,浪速区,50540,26242,24298,29924,2001-04-01
1589,大阪市,2598242,1272166,1326076,1174546,2001-04-01
1590,北区,92414,44656,47758,47722,2001-04-01
1591,都島区,97674,47896,49778,43589,2001-04-01
1592,福島区,56155,26717,29438,25510,2001-04-01
1593,此花区,64869,32037,32832,27173,2001-04-01
1594,西淀川区,92760,46255,46505,38873,2001-04-01
1595,西区,64007,30423,33584,31233,2001-04-01
1596,港区,86893,42898,43995,37924,2001-04-01
1597,大正区,74603,37159,37444,30816,2001-04-01
1598,天王寺区,59210,27783,31427,27168,2001-04-01
1599,中央区,55958,25932,30026,29924,2001-04-01
1600,生野区,142137,67814,74323,59785,2001-05-01
1601,旭区,98822,47665,51157,44324,2001-05-01
1602,城東区,157854,75963,81891,68682,2001-05-01
1603,鶴見区,103042,50469,52573,39602,2001-05-01
1604,阿倍野区,104662,48593,56069,45934,2001-05-01
1605,住吉区,160947,76296,84651,72483,2001-05-01
1606,東住吉区,138947,66160,72787,60312,2001-05-01
1607,平野区,201859,97424,104435,81478,2001-05-01
1608,西成区,136679,78572,58107,76000,2001-05-01
1609,東成区,78687,37747,40940,34554,2001-05-01
1610,住之江区,134768,65373,69395,54444,2001-05-01
1611,東淀川区,183129,91361,91768,88787,2001-05-01
1612,淀川区,164061,81861,82200,81207,2001-05-01
1613,西淀川区,93189,46463,46726,39130,2001-05-01
1614,北区,92975,44925,48050,48209,2001-05-01
1615,都島区,97948,48024,49924,43826,2001-05-01
1616,福島区,56347,26806,29541,25745,2001-05-01
1617,此花区,64833,32010,32823,27220,2001-05-01
1618,中央区,56662,26258,30404,30475,2001-05-01
1619,大阪市,2603661,1274681,1328980,1180196,2001-05-01
1620,港区,86897,42893,44004,38040,2001-05-01
1621,大正区,74585,37144,37441,30864,2001-05-01
1622,天王寺区,59566,27945,31621,27393,2001-05-01
1623,浪速区,50795,26367,24428,30164,2001-05-01
1624,西区,64270,30548,33722,31538,2001-05-01
1625,東成区,78753,37773,40980,34594,2001-06-01
1626,生野区,142120,67806,74314,59869,2001-06-01
1627,旭区,98712,47604,51108,44324,2001-06-01
1628,城東区,157916,75985,81931,68747,2001-06-01
1629,鶴見区,103270,50569,52701,39728,2001-06-01
1630,住之江区,134772,65366,69406,54461,2001-06-01
1631,住吉区,161119,76367,84752,72620,2001-06-01
1632,東住吉区,138888,66127,72761,60329,2001-06-01
1633,平野区,202036,97491,104545,81582,2001-06-01
1634,東淀川区,183062,91326,91736,88846,2001-06-01
1635,阿倍野区,104702,48613,56089,46023,2001-06-01
1636,淀川区,164240,81937,82303,81385,2001-06-01
1637,西成区,136774,78660,58114,76211,2001-06-01
1638,浪速区,50900,26414,24486,30289,2001-06-01
1639,大阪市,2605170,1275310,1329860,1182384,2001-06-01
1640,北区,93131,44999,48132,48400,2001-06-01
1641,都島区,98025,48056,49969,43936,2001-06-01
1642,福島区,56408,26833,29575,25865,2001-06-01
1643,此花区,64853,32010,32843,27240,2001-06-01
1644,西淀川区,93225,46474,46751,39165,2001-06-01
1645,西区,64433,30625,33808,31708,2001-06-01
1646,港区,86878,42877,44001,38067,2001-06-01
1647,大正区,74464,37078,37386,30876,2001-06-01
1648,天王寺区,59584,27949,31635,27413,2001-06-01
1649,中央区,56905,26371,30534,30706,2001-06-01
1650,東成区,78706,37744,40962,34637,2001-07-01
1651,生野区,141917,67709,74208,59840,2001-07-01
1652,旭区,98694,47587,51107,44326,2001-07-01
1653,城東区,157824,75932,81892,68778,2001-07-01
1654,鶴見区,103254,50550,52704,39752,2001-07-01
1655,住之江区,134811,65375,69436,54551,2001-07-01
1656,住吉区,160972,76287,84685,72649,2001-07-01
1657,東住吉区,138807,66084,72723,60343,2001-07-01
1658,平野区,201835,97375,104460,81562,2001-07-01
1659,東淀川区,182880,91233,91647,88825,2001-07-01
1660,阿倍野区,104836,48676,56160,46078,2001-07-01
1661,淀川区,164365,81986,82379,81536,2001-07-01
1662,西成区,136726,78665,58061,76325,2001-07-01
1663,浪速区,51171,26547,24624,30524,2001-07-01
1664,大阪市,2605126,1275169,1329957,1183737,2001-07-01
1665,北区,93304,45080,48224,48531,2001-07-01
1666,都島区,98064,48069,49995,44022,2001-07-01
1667,福島区,56346,26802,29544,25865,2001-07-01
1668,此花区,64794,31971,32823,27231,2001-07-01
1669,西淀川区,93139,46425,46714,39147,2001-07-01
1670,西区,64614,30711,33903,31915,2001-07-01
1671,港区,86762,42813,43949,38060,2001-07-01
1672,大正区,74442,37061,37381,30897,2001-07-01
1673,天王寺区,59574,27939,31635,27402,2001-07-01
1674,中央区,57289,26548,30741,30941,2001-07-01
1675,東成区,78673,37722,40951,34666,2001-08-01
1676,生野区,141840,67673,74167,59858,2001-08-01
1677,旭区,98627,47547,51080,44289,2001-08-01
1678,城東区,157876,75948,81928,68857,2001-08-01
1679,鶴見区,103483,50650,52833,39834,2001-08-01
1680,住之江区,134762,65342,69420,54540,2001-08-01
1681,住吉区,160950,76265,84685,72630,2001-08-01
1682,東住吉区,138732,66043,72689,60364,2001-08-01
1683,平野区,201933,97403,104530,81684,2001-08-01
1684,東淀川区,182841,91212,91629,88862,2001-08-01
1685,阿倍野区,104811,48666,56145,46106,2001-08-01
1686,西成区,136768,78723,58045,76499,2001-08-01
1687,淀川区,164484,82032,82452,81626,2001-08-01
1688,浪速区,51310,26611,24699,30672,2001-08-01
1689,西淀川区,93178,46438,46740,39182,2001-08-01
1690,大阪市,2606027,1275501,1330526,1185181,2001-08-01
1691,北区,93401,45126,48275,48613,2001-08-01
1692,福島区,56395,26823,29572,25910,2001-08-01
1693,此花区,64757,31943,32814,27227,2001-08-01
1694,都島区,98137,48099,50038,44111,2001-08-01
1695,西区,64761,30781,33980,32095,2001-08-01
1696,港区,86784,42817,43967,38102,2001-08-01
1697,大正区,74389,37028,37361,30918,2001-08-01
1698,天王寺区,59598,27946,31652,27420,2001-08-01
1699,中央区,57537,26663,30874,31116,2001-08-01
1700,城東区,157986,75993,81993,68900,2001-09-01
1701,東成区,78586,37675,40911,34660,2001-09-01
1702,生野区,141739,67625,74114,59881,2001-09-01
1703,旭区,98603,47528,51075,44290,2001-09-01
1704,阿倍野区,104895,48706,56189,46153,2001-09-01
1705,東淀川区,182899,91239,91660,88935,2001-09-01
1706,住吉区,160914,76238,84676,72646,2001-09-01
1707,東住吉区,138552,65952,72600,60301,2001-09-01
1708,平野区,202024,97429,104595,81781,2001-09-01
1709,西成区,136844,78800,58044,76675,2001-09-01
1710,住之江区,134853,65376,69477,54629,2001-09-01
1711,淀川区,164505,82029,82476,81687,2001-09-01
1712,鶴見区,103581,50687,52894,39882,2001-09-01
1713,浪速区,51387,26644,24743,30735,2001-09-01
1714,北区,93370,45109,48261,48656,2001-09-01
1715,都島区,98215,48131,50084,44196,2001-09-01
1716,福島区,56438,26842,29596,25973,2001-09-01
1717,此花区,64753,31931,32822,27235,2001-09-01
1718,中央区,57856,26811,31045,31353,2001-09-01
1719,大阪市,2606662,1275706,1330956,1186397,2001-09-01
1720,西区,64810,30804,34006,32214,2001-09-01
1721,港区,86744,42790,43954,38102,2001-09-01
1722,大正区,74321,36988,37333,30881,2001-09-01
1723,天王寺区,59550,27918,31632,27443,2001-09-01
1724,西淀川区,93237,46461,46776,39189,2001-09-01
1725,生野区,141728,67620,74108,59906,2001-10-01
1726,旭区,98523,47481,51042,44246,2001-10-01
1727,城東区,158025,76003,82022,68957,2001-10-01
1728,鶴見区,103613,50691,52922,39908,2001-10-01
1729,阿倍野区,104957,48736,56221,46165,2001-10-01
1730,住吉区,160845,76194,84651,72582,2001-10-01
1731,東住吉区,138458,65902,72556,60311,2001-10-01
1732,平野区,202030,97413,104617,81812,2001-10-01
1733,西成区,136836,78829,58007,76812,2001-10-01
1734,東成区,78553,37653,40900,34678,2001-10-01
1735,住之江区,134863,65371,69492,54645,2001-10-01
1736,東淀川区,182874,91225,91649,88986,2001-10-01
1737,淀川区,164571,82049,82522,81750,2001-10-01
1738,西淀川区,93317,46494,46823,39185,2001-10-01
1739,北区,93319,45082,48237,48632,2001-10-01
1740,都島区,98342,48187,50155,44219,2001-10-01
1741,福島区,56417,26830,29587,25980,2001-10-01
1742,此花区,64696,31893,32803,27225,2001-10-01
1743,中央区,58173,26958,31215,31574,2001-10-01
1744,大阪市,2607059,1275786,1331273,1187131,2001-10-01
1745,港区,86691,42757,43934,38099,2001-10-01
1746,大正区,74316,36980,37336,30849,2001-10-01
1747,天王寺区,59542,27910,31632,27440,2001-10-01
1748,浪速区,51528,26709,24819,30833,2001-10-01
1749,西区,64842,30819,34023,32337,2001-10-01
1750,生野区,141855,67681,74174,59970,2001-11-01
1751,旭区,98499,47462,51037,44243,2001-11-01
1752,城東区,158011,75988,82023,68969,2001-11-01
1753,鶴見区,103741,50742,52999,39996,2001-11-01
1754,阿倍野区,105036,48773,56263,46220,2001-11-01
1755,住吉区,160802,76163,84639,72562,2001-11-01
1756,東住吉区,138559,65946,72613,60346,2001-11-01
1757,平野区,202215,97483,104732,81938,2001-11-01
1758,西成区,137082,79004,58078,77076,2001-11-01
1759,東成区,78587,37663,40924,34691,2001-11-01
1760,住之江区,134523,65197,69326,54518,2001-11-01
1761,東淀川区,182852,91212,91640,89004,2001-11-01
1762,淀川区,164726,82113,82613,81853,2001-11-01
1763,西淀川区,93396,46527,46869,39228,2001-11-01
1764,北区,93423,45131,48292,48759,2001-11-01
1765,都島区,98375,48197,50178,44266,2001-11-01
1766,福島区,56459,26848,29611,25997,2001-11-01
1767,此花区,64664,31867,32797,27197,2001-11-01
1768,中央区,58354,27041,31313,31743,2001-11-01
1769,大阪市,2608479,1276378,1332101,1188429,2001-11-01
1770,港区,86623,42717,43906,38077,2001-11-01
1771,大正区,74270,36951,37319,30816,2001-11-01
1772,天王寺区,59652,27956,31696,27491,2001-11-01
1773,浪速区,51600,26739,24861,30910,2001-11-01
1774,西区,65175,30977,34198,32559,2001-11-01
1775,生野区,141578,67549,74029,59950,2001-12-01
1776,旭区,98353,47384,50969,44210,2001-12-01
1777,城東区,158126,76035,82091,69022,2001-12-01
1778,鶴見区,103829,50773,53056,40022,2001-12-01
1779,阿倍野区,104997,48756,56241,46214,2001-12-01
1780,住吉区,160816,76159,84657,72610,2001-12-01
1781,東住吉区,138544,65933,72611,60385,2001-12-01
1782,平野区,202368,97538,104830,82020,2001-12-01
1783,西成区,136997,78988,58009,77097,2001-12-01
1784,東成区,78648,37686,40962,34726,2001-12-01
1785,住之江区,134527,65189,69338,54515,2001-12-01
1786,東淀川区,182846,91207,91639,88975,2001-12-01
1787,淀川区,164873,82173,82700,81964,2001-12-01
1788,西淀川区,93499,46571,46928,39289,2001-12-01
1789,北区,93473,45153,48320,48851,2001-12-01
1790,都島区,98560,48282,50278,44267,2001-12-01
1791,福島区,56565,26897,29668,26074,2001-12-01
1792,此花区,64606,31829,32777,27171,2001-12-01
1793,中央区,58451,27086,31365,31845,2001-12-01
1794,大阪市,2609001,1276511,1332490,1189274,2001-12-01
1795,港区,86520,42659,43861,38025,2001-12-01
1796,大正区,74206,36913,37293,30802,2001-12-01
1797,天王寺区,59607,27930,31677,27498,2001-12-01
1798,浪速区,51608,26735,24873,30983,2001-12-01
1799,西区,65404,31086,34318,32759,2001-12-01
1800,生野区,141420,67474,73946,59916,2002-01-01
1801,旭区,98307,47354,50953,44158,2002-01-01
1802,城東区,158432,76173,82259,69173,2002-01-01
1803,鶴見区,103812,50753,53059,40032,2002-01-01
1804,阿倍野区,105013,48765,56248,46210,2002-01-01
1805,住吉区,160782,76132,84650,72602,2002-01-01
1806,東住吉区,138553,65933,72620,60405,2002-01-01
1807,平野区,202318,97495,104823,82032,2002-01-01
1808,西成区,136877,78952,57925,76992,2002-01-01
1809,東成区,78554,37635,40919,34743,2002-01-01
1810,住之江区,134482,65158,69324,54513,2002-01-01
1811,東淀川区,182835,91200,91635,88961,2002-01-01
1812,淀川区,164877,82161,82716,81985,2002-01-01
1813,西淀川区,93570,46600,46970,39320,2002-01-01
1814,北区,93531,45179,48352,48810,2002-01-01
1815,都島区,98469,48231,50238,44273,2002-01-01
1816,福島区,56500,26864,29636,26047,2002-01-01
1817,此花区,64682,31857,32825,27230,2002-01-01
1818,中央区,58287,27010,31277,31930,2002-01-01
1819,大阪市,2608726,1276257,1332469,1189649,2002-01-01
1820,港区,86301,42545,43756,37946,2002-01-01
1821,大正区,74171,36890,37281,30812,2002-01-01
1822,天王寺区,59740,27988,31752,27570,2002-01-01
1823,浪速区,51587,26717,24870,31046,2002-01-01
1824,西区,65626,31191,34435,32943,2002-01-01
1825,生野区,141232,67384,73848,59894,2002-02-01
1826,旭区,98225,47307,50918,44066,2002-02-01
1827,城東区,158422,76160,82262,69186,2002-02-01
1828,鶴見区,103807,50739,53068,40029,2002-02-01
1829,阿倍野区,105009,48764,56245,46183,2002-02-01
1830,住吉区,160735,76099,84636,72584,2002-02-01
1831,東住吉区,138472,65889,72583,60411,2002-02-01
1832,平野区,202226,97432,104794,82024,2002-02-01
1833,西成区,136903,79001,57902,77131,2002-02-01
1834,東成区,78574,37639,40935,34755,2002-02-01
1835,住之江区,134398,65108,69290,54441,2002-02-01
1836,東淀川区,182746,91153,91593,88937,2002-02-01
1837,淀川区,165230,82324,82906,82171,2002-02-01
1838,西淀川区,93476,46547,46929,39254,2002-02-01
1839,北区,93418,45123,48295,48761,2002-02-01
1840,都島区,98426,48204,50222,44274,2002-02-01
1841,福島区,56517,26870,29647,26086,2002-02-01
1842,此花区,64929,31969,32960,27372,2002-02-01
1843,中央区,58484,27101,31383,32039,2002-02-01
1844,大阪市,2608611,1276089,1332522,1190089,2002-02-01
1845,港区,86002,42390,43612,37842,2002-02-01
1846,大正区,74074,36836,37238,30785,2002-02-01
1847,天王寺区,59813,28017,31796,27602,2002-02-01
1848,浪速区,51593,26712,24881,31120,2002-02-01
1849,西区,65900,31321,34579,33142,2002-02-01
1850,生野区,141092,67318,73774,59888,2002-03-01
1851,旭区,98226,47299,50927,44052,2002-03-01
1852,城東区,158602,76238,82364,69271,2002-03-01
1853,鶴見区,103729,50690,53039,40015,2002-03-01
1854,阿倍野区,105041,48780,56261,46222,2002-03-01
1855,住吉区,160842,76139,84703,72676,2002-03-01
1856,東住吉区,138447,65872,72575,60437,2002-03-01
1857,平野区,202215,97408,104807,82073,2002-03-01
1858,西成区,136777,78962,57815,77227,2002-03-01
1859,東成区,78498,37596,40902,34760,2002-03-01
1860,住之江区,134371,65085,69286,54471,2002-03-01
1861,東淀川区,182821,91189,91632,89005,2002-03-01
1862,淀川区,165367,82379,82988,82145,2002-03-01
1863,西淀川区,93560,46582,46978,39259,2002-03-01
1864,北区,93435,45129,48306,48804,2002-03-01
1865,都島区,98350,48161,50189,44256,2002-03-01
1866,福島区,56543,26881,29662,26103,2002-03-01
1867,此花区,64899,31944,32955,27377,2002-03-01
1868,中央区,58522,27119,31403,32139,2002-03-01
1869,大阪市,2608804,1276058,1332746,1190959,2002-03-01
1870,港区,86017,42391,43626,37910,2002-03-01
1871,大正区,74011,36798,37213,30799,2002-03-01
1872,天王寺区,59932,28068,31864,27636,2002-03-01
1873,浪速区,51556,26685,24871,31175,2002-03-01
1874,西区,65951,31345,34606,33259,2002-03-01
1875,生野区,141038,67292,73746,59939,2002-04-01
1876,旭区,98155,47257,50898,44075,2002-04-01
1877,城東区,158731,76291,82440,69442,2002-04-01
1878,鶴見区,103464,50548,52916,39961,2002-04-01
1879,阿倍野区,104972,48749,56223,46217,2002-04-01
1880,住吉区,160663,76044,84619,72715,2002-04-01
1881,東住吉区,138386,65838,72548,60453,2002-04-01
1882,平野区,201854,97215,104639,82070,2002-04-01
1883,西成区,136837,79030,57807,77479,2002-04-01
1884,東成区,78581,37630,40951,34865,2002-04-01
1885,住之江区,133902,64849,69053,54442,2002-04-01
1886,東淀川区,182528,91041,91487,89044,2002-04-01
1887,淀川区,165955,82659,83296,82602,2002-04-01
1888,西淀川区,93435,46513,46922,39277,2002-04-01
1889,北区,93579,45197,48382,49037,2002-04-01
1890,都島区,98228,48095,50133,44333,2002-04-01
1891,福島区,56641,26925,29716,26230,2002-04-01
1892,此花区,64855,31913,32942,27420,2002-04-01
1893,中央区,58829,27261,31568,32421,2002-04-01
1894,大阪市,2608185,1275649,1332536,1193369,2002-04-01
1895,港区,85835,42295,43540,37934,2002-04-01
1896,大正区,73925,36750,37175,30801,2002-04-01
1897,天王寺区,59985,28088,31897,27697,2002-04-01
1898,浪速区,51647,26725,24922,31357,2002-04-01
1899,西区,66160,31444,34716,33558,2002-04-01
1900,東成区,78659,37661,40998,34989,2002-05-01
1901,生野区,141193,67367,73826,60141,2002-05-01
1902,旭区,98309,47324,50985,44218,2002-05-01
1903,城東区,158954,76390,82564,69655,2002-05-01
1904,鶴見区,103509,50559,52950,40083,2002-05-01
1905,住之江区,134036,64904,69132,54694,2002-05-01
1906,住吉区,160877,76134,84743,72925,2002-05-01
1907,東住吉区,138639,65954,72685,60669,2002-05-01
1908,平野区,201990,97262,104728,82225,2002-05-01
1909,東淀川区,182832,91191,91641,89409,2002-05-01
1910,阿倍野区,105268,48887,56381,46501,2002-05-01
1911,淀川区,166422,82878,83544,83059,2002-05-01
1912,西成区,137004,79159,57845,77771,2002-05-01
1913,浪速区,51950,26874,25076,31499,2002-05-01
1914,大阪市,2613630,1278180,1335450,1199004,2002-05-01
1915,北区,93971,45385,48586,49434,2002-05-01
1916,都島区,98444,48195,50249,44556,2002-05-01
1917,福島区,56882,27038,29844,26470,2002-05-01
1918,此花区,64940,31945,32995,27542,2002-05-01
1919,西淀川区,93537,46558,46979,39419,2002-05-01
1920,西区,66688,31695,34993,34069,2002-05-01
1921,港区,85911,42325,43586,38058,2002-05-01
1922,大正区,73943,36752,37191,30854,2002-05-01
1923,天王寺区,60243,28204,32039,27919,2002-05-01
1924,中央区,59429,27539,31890,32845,2002-05-01
1925,生野区,141136,67340,73796,60212,2002-06-01
1926,旭区,98447,47382,51065,44267,2002-06-01
1927,城東区,158925,76368,82557,69672,2002-06-01
1928,鶴見区,103659,50621,53038,40192,2002-06-01
1929,阿倍野区,105255,48883,56372,46509,2002-06-01
1930,住吉区,160903,76136,84767,72985,2002-06-01
1931,東住吉区,138660,65959,72701,60712,2002-06-01
1932,平野区,202125,97308,104817,82320,2002-06-01
1933,西成区,136993,79186,57807,77918,2002-06-01
1934,東成区,78707,37678,41029,35034,2002-06-01
1935,住之江区,134008,64881,69127,54737,2002-06-01
1936,東淀川区,182866,91206,91660,89502,2002-06-01
1937,淀川区,166589,82947,83642,83246,2002-06-01
1938,西淀川区,93529,46547,46982,39434,2002-06-01
1939,北区,94175,45482,48693,49600,2002-06-01
1940,都島区,98562,48247,50315,44661,2002-06-01
1941,福島区,56873,27032,29841,26525,2002-06-01
1942,此花区,65063,31995,33068,27609,2002-06-01
1943,中央区,59517,27579,31938,33015,2002-06-01
1944,大阪市,2614794,1278629,1336165,1200829,2002-06-01
1945,港区,85738,42233,43505,38008,2002-06-01
1946,大正区,73881,36716,37165,30802,2002-06-01
1947,天王寺区,60296,28224,32072,27996,2002-06-01
1948,浪速区,51968,26875,25093,31586,2002-06-01
1949,西区,66919,31804,35115,34287,2002-06-01
1950,生野区,141104,67325,73779,60260,2002-07-01
1951,旭区,98433,47368,51065,44267,2002-07-01
1952,城東区,158982,76386,82596,69677,2002-07-01
1953,鶴見区,103765,50661,53104,40253,2002-07-01
1954,阿倍野区,105235,48874,56361,46487,2002-07-01
1955,住吉区,160815,76083,84732,72937,2002-07-01
1956,東住吉区,138648,65948,72700,60748,2002-07-01
1957,平野区,201986,97223,104763,82281,2002-07-01
1958,西成区,137061,79259,57802,78098,2002-07-01
1959,東成区,78650,37645,41005,35040,2002-07-01
1960,住之江区,133984,64860,69124,54755,2002-07-01
1961,東淀川区,182868,91205,91663,89527,2002-07-01
1962,淀川区,166572,82926,83646,83191,2002-07-01
1963,西淀川区,93499,46526,46973,39405,2002-07-01
1964,北区,94214,45499,48715,49686,2002-07-01
1965,都島区,98492,48206,50286,44640,2002-07-01
1966,福島区,56906,27046,29860,26558,2002-07-01
1967,此花区,65062,31985,33077,27610,2002-07-01
1968,中央区,59594,27615,31979,33131,2002-07-01
1969,大阪市,2614970,1278610,1336360,1201548,2002-07-01
1970,港区,85730,42223,43507,38036,2002-07-01
1971,大正区,73890,36714,37176,30807,2002-07-01
1972,天王寺区,60414,28274,32140,28077,2002-07-01
1973,浪速区,52023,26896,25127,31649,2002-07-01
1974,西区,67043,31863,35180,34428,2002-07-01
1975,生野区,140959,67256,73703,60290,2002-08-01
1976,旭区,98356,47323,51033,44228,2002-08-01
1977,城東区,158903,76340,82563,69651,2002-08-01
1978,鶴見区,103848,50690,53158,40303,2002-08-01
1979,阿倍野区,105249,48882,56367,46508,2002-08-01
1980,住吉区,160805,76068,84737,72920,2002-08-01
1981,東住吉区,138602,65921,72681,60740,2002-08-01
1982,平野区,201972,97197,104775,82330,2002-08-01
1983,西成区,137018,79268,57750,78188,2002-08-01
1984,東成区,78608,37619,40989,35051,2002-08-01
1985,住之江区,133904,64811,69093,54748,2002-08-01
1986,東淀川区,182720,91129,91591,89516,2002-08-01
1987,淀川区,166679,82965,83714,83228,2002-08-01
1988,西淀川区,93498,46519,46979,39446,2002-08-01
1989,北区,94267,45522,48745,49775,2002-08-01
1990,都島区,98736,48320,50416,44778,2002-08-01
1991,福島区,56965,27072,29893,26646,2002-08-01
1992,此花区,65047,31968,33079,27632,2002-08-01
1993,中央区,59775,27699,32076,33306,2002-08-01
1994,大阪市,2615055,1278535,1336520,1202520,2002-08-01
1995,港区,85736,42219,43517,38049,2002-08-01
1996,大正区,73879,36703,37176,30832,2002-08-01
1997,天王寺区,60456,28289,32167,28130,2002-08-01
1998,浪速区,52012,26883,25129,31691,2002-08-01
1999,西区,67061,31872,35189,34534,2002-08-01
2000,東成区,78441,37533,40908,35030,2002-09-01
2001,生野区,140941,67247,73694,60326,2002-09-01
2002,旭区,98334,47305,51029,44247,2002-09-01
2003,城東区,158959,76358,82601,69647,2002-09-01
2004,鶴見区,103894,50701,53193,40351,2002-09-01
2005,住之江区,133776,64740,69036,54720,2002-09-01
2006,住吉区,160892,76098,84794,72956,2002-09-01
2007,東住吉区,138493,65864,72629,60744,2002-09-01
2008,平野区,202027,97205,104822,82427,2002-09-01
2009,東淀川区,182471,91003,91468,89402,2002-09-01
2010,阿倍野区,105307,48910,56397,46532,2002-09-01
2011,淀川区,166759,82992,83767,83330,2002-09-01
2012,西成区,136924,79247,57677,78282,2002-09-01
2013,浪速区,52027,26883,25144,31712,2002-09-01
2014,大阪市,2614973,1278370,1336603,1203395,2002-09-01
2015,北区,94246,45510,48736,49822,2002-09-01
2016,都島区,98744,48317,50427,44820,2002-09-01
2017,福島区,56940,27058,29882,26676,2002-09-01
2018,此花区,64960,31915,33045,27619,2002-09-01
2019,西淀川区,93858,46691,47167,39616,2002-09-01
2020,西区,67148,31913,35235,34681,2002-09-01
2021,港区,85649,42169,43480,38035,2002-09-01
2022,大正区,73830,36672,37158,30819,2002-09-01
2023,天王寺区,60551,28328,32223,28202,2002-09-01
2024,中央区,59802,27711,32091,33399,2002-09-01
2025,生野区,140912,67234,73678,60342,2002-10-01
2026,旭区,98262,47262,51000,44216,2002-10-01
2027,城東区,158950,76345,82605,69653,2002-10-01
2028,鶴見区,104036,50758,53278,40408,2002-10-01
2029,阿倍野区,105413,48960,56453,46583,2002-10-01
2030,住吉区,160721,76007,84714,72885,2002-10-01
2031,東住吉区,138349,65791,72558,60677,2002-10-01
2032,平野区,202028,97186,104842,82455,2002-10-01
2033,西成区,136842,79233,57609,78382,2002-10-01
2034,東成区,78533,37571,40962,35095,2002-10-01
2035,住之江区,133760,64723,69037,54738,2002-10-01
2036,東淀川区,182272,90902,91370,89362,2002-10-01
2037,淀川区,166743,82970,83773,83299,2002-10-01
2038,西淀川区,93931,46721,47210,39677,2002-10-01
2039,北区,94255,45513,48742,49838,2002-10-01
2040,都島区,98776,48327,50449,44835,2002-10-01
2041,福島区,57133,27148,29985,26780,2002-10-01
2042,此花区,64866,31859,33007,27588,2002-10-01
2043,中央区,59839,27728,32111,33478,2002-10-01
2044,大阪市,2614875,1278203,1336672,1203898,2002-10-01
2045,港区,85609,42143,43466,37994,2002-10-01
2046,大正区,73764,36634,37130,30798,2002-10-01
2047,天王寺区,60543,28320,32223,28191,2002-10-01
2048,浪速区,52101,26913,25188,31780,2002-10-01
2049,西区,67237,31955,35282,34844,2002-10-01
2050,東成区,78677,37634,41043,35160,2002-11-01
2051,生野区,140848,67204,73644,60329,2002-11-01
2052,旭区,98245,47246,50999,44213,2002-11-01
2053,城東区,158902,76314,82588,69593,2002-11-01
2054,鶴見区,104081,50769,53312,40444,2002-11-01
2055,住之江区,133710,64689,69021,54764,2002-11-01
2056,住吉区,160727,75999,84728,72882,2002-11-01
2057,東住吉区,138338,65781,72557,60672,2002-11-01
2058,平野区,202285,97291,104994,82520,2002-11-01
2059,東淀川区,182274,90901,91373,89345,2002-11-01
2060,阿倍野区,105505,49004,56501,46661,2002-11-01
2061,淀川区,166749,82960,83789,83279,2002-11-01
2062,西成区,136761,79219,57542,78413,2002-11-01
2063,浪速区,52107,26908,25199,31840,2002-11-01
2064,大阪市,2615700,1278476,1337224,1204731,2002-11-01
2065,北区,94378,45571,48807,49967,2002-11-01
2066,都島区,98775,48321,50454,44837,2002-11-01
2067,福島区,57180,27168,30012,26823,2002-11-01
2068,此花区,64799,31816,32983,27579,2002-11-01
2069,西淀川区,94028,46763,47265,39712,2002-11-01
2070,西区,67458,32060,35398,35041,2002-11-01
2071,港区,85533,42099,43434,37979,2002-11-01
2072,大正区,73719,36605,37114,30815,2002-11-01
2073,天王寺区,60675,28377,32298,28252,2002-11-01
2074,中央区,59946,27777,32169,33611,2002-11-01
2075,東成区,78617,37599,41018,35197,2002-12-01
2076,生野区,140875,67217,73658,60387,2002-12-01
2077,旭区,98057,47148,50909,44157,2002-12-01
2078,城東区,159159,76429,82730,69683,2002-12-01
2079,鶴見区,104161,50796,53365,40451,2002-12-01
2080,住之江区,133633,64642,68991,54757,2002-12-01
2081,住吉区,160783,76015,84768,72915,2002-12-01
2082,東住吉区,138228,65723,72505,60685,2002-12-01
2083,平野区,202127,97197,104930,82436,2002-12-01
2084,東淀川区,182239,90882,91357,89355,2002-12-01
2085,阿倍野区,105660,49077,56583,46721,2002-12-01
2086,淀川区,166912,83028,83884,83330,2002-12-01
2087,西成区,136600,79159,57441,78271,2002-12-01
2088,浪速区,52159,26928,25231,31902,2002-12-01
2089,大阪市,2615822,1278406,1337416,1205371,2002-12-01
2090,北区,94500,45628,48872,50095,2002-12-01
2091,都島区,98711,48283,50428,44831,2002-12-01
2092,福島区,57356,27250,30106,26935,2002-12-01
2093,此花区,64664,31740,32924,27543,2002-12-01
2094,西淀川区,94091,46787,47304,39719,2002-12-01
2095,西区,67577,32116,35461,35193,2002-12-01
2096,港区,85382,42018,43364,37939,2002-12-01
2097,大正区,73724,36602,37122,30838,2002-12-01
2098,天王寺区,60650,28360,32290,28271,2002-12-01
2099,中央区,59957,27782,32175,33760,2002-12-01
2100,東成区,78557,37564,40993,35158,2003-01-01
2101,生野区,140798,67180,73618,60394,2003-01-01
2102,旭区,97896,47063,50833,44082,2003-01-01
2103,城東区,159101,76392,82709,69675,2003-01-01
2104,鶴見区,104160,50784,53376,40452,2003-01-01
2105,住之江区,133519,64578,68941,54750,2003-01-01
2106,住吉区,160857,76039,84818,72920,2003-01-01
2107,東住吉区,138034,65626,72408,60614,2003-01-01
2108,平野区,202019,97126,104893,82437,2003-01-01
2109,東淀川区,182197,90859,91338,89357,2003-01-01
2110,阿倍野区,105674,49085,56589,46580,2003-01-01
2111,西成区,136542,79159,57383,78237,2003-01-01
2112,淀川区,166945,83031,83914,83319,2003-01-01
2113,浪速区,52187,26934,25253,31950,2003-01-01
2114,西淀川区,94204,46837,47367,39742,2003-01-01
2115,大阪市,2615405,1278087,1337318,1205328,2003-01-01
2116,北区,94605,45677,48928,50182,2003-01-01
2117,福島区,57445,27290,30155,26983,2003-01-01
2118,此花区,64578,31688,32890,27527,2003-01-01
2119,都島区,98717,48280,50437,44851,2003-01-01
2120,西区,67595,32124,35471,35274,2003-01-01
2121,港区,85263,41953,43310,37897,2003-01-01
2122,大正区,73751,36609,37142,30799,2003-01-01
2123,天王寺区,60691,28374,32317,28293,2003-01-01
2124,中央区,60070,27835,32235,33855,2003-01-01
2125,鶴見区,104098,50742,53356,40420,2003-02-01
2126,生野区,140733,67150,73583,60414,2003-02-01
2127,旭区,97774,46997,50777,44029,2003-02-01
2128,城東区,158972,76322,82650,69626,2003-02-01
2129,阿倍野区,105721,49108,56613,46617,2003-02-01
2130,東成区,78564,37561,41003,35173,2003-02-01
2131,住吉区,160672,75941,84731,72812,2003-02-01
2132,東住吉区,137856,65537,72319,60572,2003-02-01
2133,平野区,201888,97044,104844,82393,2003-02-01
2134,西成区,136384,79101,57283,78256,2003-02-01
2135,住之江区,133397,64509,68888,54727,2003-02-01
2136,東淀川区,182055,90786,91269,89312,2003-02-01
2137,淀川区,166816,82953,83863,83240,2003-02-01
2138,西淀川区,94212,46834,47378,39727,2003-02-01
2139,北区,94901,45818,49083,50198,2003-02-01
2140,都島区,98698,48265,50433,44854,2003-02-01
2141,福島区,57518,27323,30195,27049,2003-02-01
2142,此花区,64526,31653,32873,27519,2003-02-01
2143,中央区,60123,27859,32264,33953,2003-02-01
2144,大阪市,2614387,1277467,1336920,1205216,2003-02-01
2145,港区,85203,41917,43286,37871,2003-02-01
2146,大正区,73695,36576,37119,30760,2003-02-01
2147,天王寺区,60717,28381,32336,28310,2003-02-01
2148,浪速区,52201,26934,25267,32005,2003-02-01
2149,西区,67663,32156,35507,35379,2003-02-01
2150,生野区,140608,67090,73518,60386,2003-03-01
2151,旭区,97653,46931,50722,44005,2003-03-01
2152,城東区,158856,76258,82598,69608,2003-03-01
2153,鶴見区,103963,50665,53298,40378,2003-03-01
2154,阿倍野区,105904,49194,56710,46746,2003-03-01
2155,住吉区,160676,75932,84744,72823,2003-03-01
2156,東住吉区,137587,65404,72183,60486,2003-03-01
2157,平野区,201802,96984,104818,82377,2003-03-01
2158,西成区,136289,79079,57210,78331,2003-03-01
2159,東成区,78501,37525,40976,35163,2003-03-01
2160,住之江区,133290,64448,68842,54692,2003-03-01
2161,東淀川区,181912,90713,91199,89292,2003-03-01
2162,淀川区,166962,83012,83950,83300,2003-03-01
2163,西淀川区,94255,46849,47406,39758,2003-03-01
2164,北区,95103,45913,49190,50381,2003-03-01
2165,都島区,98682,48251,50431,44900,2003-03-01
2166,福島区,57524,27324,30200,27086,2003-03-01
2167,此花区,64477,31619,32858,27507,2003-03-01
2168,中央区,60099,27848,32251,33998,2003-03-01
2169,大阪市,2613675,1277001,1336674,1205772,2003-03-01
2170,港区,85048,41834,43214,37800,2003-03-01
2171,大正区,73652,36548,37104,30764,2003-03-01
2172,天王寺区,60831,28430,32401,28376,2003-03-01
2173,浪速区,52281,26967,25314,32126,2003-03-01
2174,西区,67720,32183,35537,35489,2003-03-01
2175,生野区,140406,66994,73412,60372,2003-04-01
2176,旭区,97401,46802,50599,43981,2003-04-01
2177,城東区,158998,76317,82681,69837,2003-04-01
2178,鶴見区,103980,50661,53319,40464,2003-04-01
2179,阿倍野区,106045,49260,56785,46882,2003-04-01
2180,住吉区,160583,75877,84706,72910,2003-04-01
2181,東住吉区,137174,65202,71972,60431,2003-04-01
2182,平野区,201516,96828,104688,82430,2003-04-01
2183,西成区,136383,79166,57217,78541,2003-04-01
2184,東成区,78673,37601,41072,35329,2003-04-01
2185,住之江区,132825,64214,68611,54590,2003-04-01
2186,東淀川区,181652,90582,91070,89384,2003-04-01
2187,淀川区,167196,83115,84081,83599,2003-04-01
2188,西淀川区,94292,46861,47431,39838,2003-04-01
2189,北区,95579,46141,49438,50847,2003-04-01
2190,都島区,98592,48201,50391,45008,2003-04-01
2191,福島区,57624,27370,30254,27226,2003-04-01
2192,此花区,64507,31624,32883,27593,2003-04-01
2193,中央区,60308,27944,32364,34219,2003-04-01
2194,大阪市,2613922,1277009,1336913,1208897,2003-04-01
2195,港区,84830,41720,43110,37747,2003-04-01
2196,大正区,73596,36515,37081,30803,2003-04-01
2197,天王寺区,61136,28567,32569,28576,2003-04-01
2198,浪速区,52448,27046,25402,32336,2003-04-01
2199,西区,68178,32401,35777,35954,2003-04-01
2200,生野区,140521,67049,73472,60562,2003-05-01
2201,旭区,97443,46814,50629,44085,2003-05-01
2202,城東区,159239,76424,82815,70082,2003-05-01
2203,鶴見区,104288,50800,53488,40641,2003-05-01
2204,阿倍野区,106302,49381,56921,47151,2003-05-01
2205,住吉区,160754,75947,84807,73102,2003-05-01
2206,東住吉区,137284,65250,72034,60512,2003-05-01
2207,平野区,201475,96789,104686,82444,2003-05-01
2208,西成区,136490,79262,57228,78781,2003-05-01
2209,東成区,78733,37624,41109,35449,2003-05-01
2210,住之江区,132743,64165,68578,54692,2003-05-01
2211,東淀川区,181876,90692,91184,89673,2003-05-01
2212,淀川区,167641,83323,84318,83981,2003-05-01
2213,西淀川区,94385,46901,47484,39944,2003-05-01
2214,北区,96025,46355,49670,51203,2003-05-01
2215,都島区,98778,48286,50492,45142,2003-05-01
2216,福島区,57969,27532,30437,27448,2003-05-01
2217,此花区,64571,31646,32925,27692,2003-05-01
2218,中央区,60906,28221,32685,34678,2003-05-01
2219,大阪市,2618375,1279055,1339320,1213480,2003-05-01
2220,港区,84794,41695,43099,37798,2003-05-01
2221,大正区,73583,36502,37081,30836,2003-05-01
2222,天王寺区,61276,28628,32648,28703,2003-05-01
2223,浪速区,52719,27177,25542,32519,2003-05-01
2224,西区,68580,32592,35988,36362,2003-05-01
2225,生野区,140469,67025,73444,60635,2003-06-01
2226,旭区,97459,46814,50645,44117,2003-06-01
2227,城東区,159350,76469,82881,70125,2003-06-01
2228,鶴見区,104321,50804,53517,40659,2003-06-01
2229,阿倍野区,106302,49382,56920,47148,2003-06-01
2230,住吉区,160776,75947,84829,73154,2003-06-01
2231,東住吉区,137223,65216,72007,60538,2003-06-01
2232,平野区,201577,96820,104757,82539,2003-06-01
2233,西成区,136464,79280,57184,78918,2003-06-01
2234,東成区,78754,37628,41126,35466,2003-06-01
2235,住之江区,132664,64117,68547,54701,2003-06-01
2236,東淀川区,181846,90675,91171,89725,2003-06-01
2237,淀川区,167781,83379,84402,84137,2003-06-01
2238,西淀川区,94398,46900,47498,39979,2003-06-01
2239,北区,96235,46454,49781,51365,2003-06-01
2240,都島区,98738,48260,50478,45197,2003-06-01
2241,福島区,58050,27568,30482,27519,2003-06-01
2242,此花区,64539,31621,32918,27689,2003-06-01
2243,中央区,61075,28299,32776,34822,2003-06-01
2244,大阪市,2619140,1279307,1339833,1215008,2003-06-01
2245,港区,84655,41620,43035,37775,2003-06-01
2246,大正区,73565,36487,37078,30846,2003-06-01
2247,天王寺区,61334,28650,32684,28776,2003-06-01
2248,浪速区,52840,27232,25608,32605,2003-06-01
2249,西区,68725,32660,36065,36573,2003-06-01
2250,生野区,140374,66980,73394,60695,2003-07-01
2251,旭区,97409,46783,50626,44110,2003-07-01
2252,城東区,159276,76425,82851,70098,2003-07-01
2253,鶴見区,104383,50823,53560,40701,2003-07-01
2254,阿倍野区,106311,49387,56924,47130,2003-07-01
2255,住吉区,160710,75905,84805,73147,2003-07-01
2256,東住吉区,137132,65168,71964,60517,2003-07-01
2257,平野区,201635,96829,104806,82625,2003-07-01
2258,西成区,136323,79231,57092,78983,2003-07-01
2259,東成区,78755,37623,41132,35471,2003-07-01
2260,住之江区,132646,64099,68547,54725,2003-07-01
2261,東淀川区,181774,90637,91137,89685,2003-07-01
2262,淀川区,167817,83383,84434,84167,2003-07-01
2263,西淀川区,94421,46905,47516,39984,2003-07-01
2264,北区,96320,46494,49826,51426,2003-07-01
2265,都島区,98702,48236,50466,45179,2003-07-01
2266,福島区,58088,27584,30504,27555,2003-07-01
2267,此花区,64657,31669,32988,27754,2003-07-01
2268,中央区,61278,28393,32885,35037,2003-07-01
2269,大阪市,2619233,1279224,1340009,1215882,2003-07-01
2270,港区,84627,41600,43027,37786,2003-07-01
2271,大正区,73539,36468,37071,30877,2003-07-01
2272,天王寺区,61435,28692,32743,28826,2003-07-01
2273,浪速区,52823,27215,25608,32669,2003-07-01
2274,西区,68798,32695,36103,36735,2003-07-01
2275,生野区,140357,66972,73385,60720,2003-08-01
2276,旭区,97440,46790,50650,44151,2003-08-01
2277,城東区,159384,76468,82916,70175,2003-08-01
2278,鶴見区,104456,50847,53609,40737,2003-08-01
2279,阿倍野区,106336,49400,56936,47151,2003-08-01
2280,住吉区,160713,75896,84817,73188,2003-08-01
2281,東住吉区,137145,65169,71976,60545,2003-08-01
2282,平野区,201630,96808,104822,82644,2003-08-01
2283,西成区,136280,79240,57040,79091,2003-08-01
2284,東成区,78728,37604,41124,35477,2003-08-01
2285,住之江区,132606,64070,68536,54724,2003-08-01
2286,東淀川区,181725,90611,91114,89690,2003-08-01
2287,淀川区,167872,83397,84475,84216,2003-08-01
2288,西淀川区,94443,46910,47533,40016,2003-08-01
2289,北区,96418,46539,49879,51508,2003-08-01
2290,都島区,98673,48216,50457,45211,2003-08-01
2291,福島区,58080,27579,30501,27544,2003-08-01
2292,此花区,64645,31653,32992,27768,2003-08-01
2293,中央区,61510,28501,33009,35165,2003-08-01
2294,大阪市,2619675,1279321,1340354,1216834,2003-08-01
2295,港区,84476,41519,42957,37763,2003-08-01
2296,大正区,73583,36484,37099,30911,2003-08-01
2297,天王寺区,61384,28663,32721,28839,2003-08-01
2298,浪速区,52862,27228,25634,32693,2003-08-01
2299,西区,68929,32757,36172,36907,2003-08-01
2300,生野区,140303,66946,73357,60738,2003-09-01
2301,旭区,97315,46722,50593,44107,2003-09-01
2302,城東区,159373,76455,82918,70173,2003-09-01
2303,鶴見区,105319,51255,54064,41067,2003-09-01
2304,阿倍野区,106266,49368,56898,47103,2003-09-01
2305,住吉区,160601,75832,84769,73144,2003-09-01
2306,東住吉区,137179,65180,71999,60600,2003-09-01
2307,平野区,201610,96779,104831,82674,2003-09-01
2308,西成区,136144,79194,56950,79144,2003-09-01
2309,東成区,78833,37648,41185,35582,2003-09-01
2310,住之江区,132449,63985,68464,54679,2003-09-01
2311,東淀川区,181533,90513,91020,89635,2003-09-01
2312,淀川区,167925,83410,84515,84244,2003-09-01
2313,西淀川区,94539,46951,47588,40078,2003-09-01
2314,北区,96513,46583,49930,51583,2003-09-01
2315,都島区,98622,48185,50437,45116,2003-09-01
2316,福島区,58130,27600,30530,27587,2003-09-01
2317,此花区,64651,31646,33005,27802,2003-09-01
2318,中央区,61677,28578,33099,35335,2003-09-01
2319,大阪市,2620378,1279535,1340843,1217807,2003-09-01
2320,港区,84567,41557,43010,37828,2003-09-01
2321,大正区,73589,36481,37108,30945,2003-09-01
2322,天王寺区,61357,28646,32711,28833,2003-09-01
2323,浪速区,52886,27232,25654,32738,2003-09-01
2324,西区,68997,32789,36208,37072,2003-09-01
2325,東成区,78804,37628,41176,35586,2003-10-01
2326,生野区,140208,66901,73307,60773,2003-10-01
2327,旭区,97250,46683,50567,44061,2003-10-01
2328,城東区,159293,76408,82885,70149,2003-10-01
2329,鶴見区,105420,51292,54128,41103,2003-10-01
2330,住之江区,132387,63946,68441,54687,2003-10-01
2331,住吉区,160535,75790,84745,73140,2003-10-01
2332,東住吉区,137039,65109,71930,60555,2003-10-01
2333,平野区,201604,96758,104846,82700,2003-10-01
2334,東淀川区,181342,90416,90926,89567,2003-10-01
2335,阿倍野区,106146,49314,56832,47042,2003-10-01
2336,淀川区,167887,83377,84510,84220,2003-10-01
2337,西成区,136103,79203,56900,79267,2003-10-01
2338,浪速区,52934,27249,25685,32799,2003-10-01
2339,大阪市,2619955,1279217,1340738,1218313,2003-10-01
2340,北区,96539,46594,49945,51664,2003-10-01
2341,都島区,98690,48212,50478,45181,2003-10-01
2342,福島区,58343,27700,30643,27740,2003-10-01
2343,此花区,64650,31636,33014,27817,2003-10-01
2344,西淀川区,94636,46992,47644,40136,2003-10-01
2345,西区,69085,32830,36255,37205,2003-10-01
2346,港区,84476,41506,42970,37782,2003-10-01
2347,大正区,73495,36429,37066,30924,2003-10-01
2348,天王寺区,61357,28641,32716,28867,2003-10-01
2349,中央区,61732,28603,33129,35348,2003-10-01
2350,生野区,140209,66902,73307,60817,2003-11-01
2351,旭区,97203,46653,50550,44006,2003-11-01
2352,城東区,159215,76362,82853,70100,2003-11-01
2353,鶴見区,105606,51371,54235,41177,2003-11-01
2354,阿倍野区,106075,49282,56793,46995,2003-11-01
2355,住吉区,160585,75803,84782,73170,2003-11-01
2356,東住吉区,137039,65104,71935,60564,2003-11-01
2357,平野区,201572,96724,104848,82722,2003-11-01
2358,西成区,136050,79205,56845,79260,2003-11-01
2359,東成区,78847,37642,41205,35639,2003-11-01
2360,住之江区,132314,63901,68413,54717,2003-11-01
2361,東淀川区,181208,90347,90861,89494,2003-11-01
2362,淀川区,167794,83318,84476,84216,2003-11-01
2363,西淀川区,94667,47001,47666,40140,2003-11-01
2364,北区,96676,46658,50018,51791,2003-11-01
2365,都島区,98772,48246,50526,45242,2003-11-01
2366,福島区,58362,27707,30655,27768,2003-11-01
2367,此花区,64660,31631,33029,27851,2003-11-01
2368,中央区,61852,28659,33193,35510,2003-11-01
2369,大阪市,2620603,1279414,1341189,1219213,2003-11-01
2370,港区,84399,41461,42938,37800,2003-11-01
2371,大正区,73897,36622,37275,31127,2003-11-01
2372,天王寺区,61431,28670,32761,28915,2003-11-01
2373,浪速区,52976,27263,25713,32842,2003-11-01
2374,西区,69194,32882,36312,37350,2003-11-01
2375,生野区,140133,66866,73267,60823,2003-12-01
2376,旭区,97000,46548,50452,43939,2003-12-01
2377,城東区,159700,76586,83114,70320,2003-12-01
2378,鶴見区,105723,51416,54307,41216,2003-12-01
2379,阿倍野区,106064,49278,56786,46972,2003-12-01
2380,住吉区,160440,75724,84716,73128,2003-12-01
2381,東住吉区,137013,65087,71926,60603,2003-12-01
2382,平野区,201531,96685,104846,82796,2003-12-01
2383,西成区,135920,79163,56757,79299,2003-12-01
2384,東成区,78901,37662,41239,35673,2003-12-01
2385,住之江区,132195,63834,68361,54702,2003-12-01
2386,東淀川区,181060,90272,90788,89398,2003-12-01
2387,淀川区,167748,83281,84467,84229,2003-12-01
2388,西淀川区,94749,47035,47714,40161,2003-12-01
2389,北区,96779,46706,50073,51894,2003-12-01
2390,都島区,98820,48264,50556,45288,2003-12-01
2391,福島区,58505,27773,30732,27853,2003-12-01
2392,此花区,64619,31601,33018,27859,2003-12-01
2393,中央区,61933,28696,33237,35638,2003-12-01
2394,大阪市,2620839,1279402,1341437,1220006,2003-12-01
2395,港区,84252,41383,42869,37742,2003-12-01
2396,大正区,73989,36662,37327,31182,2003-12-01
2397,天王寺区,61487,28691,32796,28959,2003-12-01
2398,浪速区,52991,27263,25728,32823,2003-12-01
2399,西区,69287,32926,36361,37509,2003-12-01
2400,生野区,140074,66838,73236,60863,2004-01-01
2401,旭区,96872,46479,50393,43890,2004-01-01
2402,城東区,159714,76584,83130,70334,2004-01-01
2403,鶴見区,105782,51433,54349,41271,2004-01-01
2404,阿倍野区,106050,49272,56778,46897,2004-01-01
2405,住吉区,160256,75626,84630,73084,2004-01-01
2406,東住吉区,136942,65048,71894,60591,2004-01-01
2407,平野区,201344,96577,104767,82818,2004-01-01
2408,西成区,135756,79101,56655,79202,2004-01-01
2409,東成区,78790,37603,41187,35652,2004-01-01
2410,住之江区,132010,63735,68275,54595,2004-01-01
2411,東淀川区,180791,90136,90655,89292,2004-01-01
2412,淀川区,167647,83218,84429,84184,2004-01-01
2413,西淀川区,94870,47088,47782,40217,2004-01-01
2414,北区,96761,46695,50066,51926,2004-01-01
2415,都島区,98904,48299,50605,45362,2004-01-01
2416,福島区,58587,27810,30777,27916,2004-01-01
2417,此花区,64539,31552,32987,27850,2004-01-01
2418,中央区,62190,28815,33375,35891,2004-01-01
2419,大阪市,2619736,1278731,1341005,1220219,2004-01-01
2420,港区,84146,41324,42822,37726,2004-01-01
2421,大正区,74020,36671,37349,31194,2004-01-01
2422,天王寺区,61496,28690,32806,28992,2004-01-01
2423,浪速区,52905,27210,25695,32846,2004-01-01
2424,西区,69290,32927,36363,37626,2004-01-01
2425,東成区,78756,37581,41175,35664,2004-02-01
2426,生野区,139967,66787,73180,60890,2004-02-01
2427,旭区,96804,46438,50366,43866,2004-02-01
2428,城東区,159694,76566,83128,70308,2004-02-01
2429,鶴見区,105888,51473,54415,41328,2004-02-01
2430,住之江区,131961,63702,68259,54624,2004-02-01
2431,住吉区,160158,75569,84589,73032,2004-02-01
2432,東住吉区,136846,64997,71849,60538,2004-02-01
2433,平野区,201282,96528,104754,82821,2004-02-01
2434,東淀川区,180578,90028,90550,89167,2004-02-01
2435,阿倍野区,106040,49269,56771,46903,2004-02-01
2436,淀川区,167659,83210,84449,84186,2004-02-01
2437,西成区,135661,79078,56583,79199,2004-02-01
2438,浪速区,52952,27227,25725,32895,2004-02-01
2439,大阪市,2619306,1278401,1340905,1220535,2004-02-01
2440,北区,96739,46683,50056,51960,2004-02-01
2441,都島区,99060,48369,50691,45445,2004-02-01
2442,福島区,58594,27811,30783,27920,2004-02-01
2443,此花区,64562,31554,33008,27876,2004-02-01
2444,西淀川区,94869,47081,47788,40233,2004-02-01
2445,西区,69458,33007,36451,37785,2004-02-01
2446,港区,83962,41227,42735,37677,2004-02-01
2447,大正区,73975,36643,37332,31163,2004-02-01
2448,天王寺区,61546,28709,32837,29010,2004-02-01
2449,中央区,62295,28864,33431,36045,2004-02-01
2450,生野区,139977,66792,73185,60961,2004-03-01
2451,旭区,96701,46381,50320,43798,2004-03-01
2452,城東区,159617,76520,83097,70263,2004-03-01
2453,鶴見区,105901,51467,54434,41353,2004-03-01
2454,阿倍野区,106105,49300,56805,46929,2004-03-01
2455,住吉区,160121,75541,84580,72997,2004-03-01
2456,東住吉区,136709,64927,71782,60501,2004-03-01
2457,平野区,201162,96452,104710,82817,2004-03-01
2458,西成区,135596,79073,56523,79297,2004-03-01
2459,東成区,78839,37614,41225,35740,2004-03-01
2460,住之江区,131816,63623,68193,54558,2004-03-01
2461,東淀川区,180341,89908,90433,89041,2004-03-01
2462,淀川区,167635,83185,84450,84168,2004-03-01
2463,西淀川区,94841,47061,47780,40224,2004-03-01
2464,北区,96820,46720,50100,52053,2004-03-01
2465,都島区,99062,48364,50698,45459,2004-03-01
2466,福島区,58642,27832,30810,27976,2004-03-01
2467,此花区,64533,31530,33003,27859,2004-03-01
2468,中央区,62500,28958,33542,36129,2004-03-01
2469,大阪市,2618916,1278084,1340832,1220884,2004-03-01
2470,港区,83915,41197,42718,37673,2004-03-01
2471,大正区,73977,36638,37339,31156,2004-03-01
2472,天王寺区,61601,28729,32872,29048,2004-03-01
2473,浪速区,52977,27232,25745,32968,2004-03-01
2474,西区,69528,33040,36488,37916,2004-03-01
2475,東成区,78915,37644,41271,35786,2004-04-01
2476,生野区,139936,66773,73163,61038,2004-04-01
2477,旭区,96482,46269,50213,43812,2004-04-01
2478,城東区,159677,76540,83137,70458,2004-04-01
2479,鶴見区,105973,51490,54483,41469,2004-04-01
2480,住之江区,131704,63560,68144,54715,2004-04-01
2481,住吉区,159809,75383,84426,73031,2004-04-01
2482,東住吉区,136450,64799,71651,60386,2004-04-01
2483,平野区,200973,96343,104630,82856,2004-04-01
2484,東淀川区,180116,89794,90322,89248,2004-04-01
2485,阿倍野区,106224,49356,56868,47004,2004-04-01
2486,淀川区,167825,83265,84560,84386,2004-04-01
2487,西成区,135487,79043,56444,79315,2004-04-01
2488,浪速区,53098,27286,25812,33118,2004-04-01
2489,大阪市,2619623,1278297,1341326,1223794,2004-04-01
2490,北区,97112,46859,50253,52365,2004-04-01
2491,都島区,99098,48375,50723,45598,2004-04-01
2492,福島区,58752,27882,30870,28104,2004-04-01
2493,此花区,64552,31529,33023,27954,2004-04-01
2494,西淀川区,95160,47212,47948,40450,2004-04-01
2495,西区,69661,33103,36558,38130,2004-04-01
2496,港区,83822,41145,42677,37710,2004-04-01
2497,大正区,73937,36612,37325,31133,2004-04-01
2498,天王寺区,61858,28844,33014,29259,2004-04-01
2499,中央区,63002,29191,33811,36469,2004-04-01
2500,東成区,79065,37710,41355,35936,2004-05-01
2501,生野区,140047,66826,73221,61181,2004-05-01
2502,旭区,96545,46291,50254,43917,2004-05-01
2503,城東区,159935,76655,83280,70666,2004-05-01
2504,鶴見区,106022,51502,54520,41572,2004-05-01
2505,住之江区,131895,63642,68253,54889,2004-05-01
2506,住吉区,159965,75446,84519,73173,2004-05-01
2507,東住吉区,136416,64778,71638,60479,2004-05-01
2508,平野区,201220,96443,104777,83006,2004-05-01
2509,東淀川区,180499,89983,90516,89576,2004-05-01
2510,阿倍野区,106539,49504,57035,47230,2004-05-01
2511,淀川区,168227,83451,84776,84715,2004-05-01
2512,西成区,135491,79078,56413,79428,2004-05-01
2513,浪速区,53349,27407,25942,33235,2004-05-01
2514,大阪市,2625046,1280801,1344245,1228415,2004-05-01
2515,北区,97654,47119,50535,52759,2004-05-01
2516,都島区,99356,48495,50861,45767,2004-05-01
2517,福島区,59103,28047,31056,28385,2004-05-01
2518,此花区,64654,31569,33085,28044,2004-05-01
2519,西淀川区,95444,47347,48097,40604,2004-05-01
2520,西区,69958,33244,36714,38466,2004-05-01
2521,港区,83930,41192,42738,37804,2004-05-01
2522,大正区,73965,36620,37345,31167,2004-05-01
2523,天王寺区,62215,29006,33209,29503,2004-05-01
2524,中央区,63552,29446,34106,36913,2004-05-01
2525,東成区,79151,37745,41406,36033,2004-06-01
2526,生野区,140040,66823,73217,61208,2004-06-01
2527,旭区,96560,46291,50269,43952,2004-06-01
2528,城東区,159986,76671,83315,70733,2004-06-01
2529,鶴見区,106130,51543,54587,41626,2004-06-01
2530,住之江区,131908,63639,68269,54990,2004-06-01
2531,住吉区,159897,75403,84494,73146,2004-06-01
2532,東住吉区,136318,64727,71591,60444,2004-06-01
2533,平野区,201222,96425,104797,83055,2004-06-01
2534,東淀川区,180557,90010,90547,89686,2004-06-01
2535,阿倍野区,106566,49517,57049,47245,2004-06-01
2536,西成区,135411,79065,56346,79505,2004-06-01
2537,淀川区,168250,83449,84801,84787,2004-06-01
2538,浪速区,53383,27417,25966,33295,2004-06-01
2539,西淀川区,95636,47435,48201,40723,2004-06-01
2540,大阪市,2626322,1281299,1345023,1230032,2004-06-01
2541,北区,97958,47264,50694,52980,2004-06-01
2542,福島区,59149,28067,31082,28449,2004-06-01
2543,此花区,64683,31574,33109,28048,2004-06-01
2544,都島区,99430,48525,50905,45854,2004-06-01
2545,西区,70168,33343,36825,38675,2004-06-01
2546,港区,83911,41176,42735,37785,2004-06-01
2547,大正区,74025,36644,37381,31202,2004-06-01
2548,天王寺区,62236,29010,33226,29544,2004-06-01
2549,中央区,63747,29536,34211,37067,2004-06-01
2550,城東区,160085,76710,83375,70805,2004-07-01
2551,東成区,79201,37763,41438,36072,2004-07-01
2552,生野区,140038,66822,73216,61257,2004-07-01
2553,旭区,96468,46239,50229,43919,2004-07-01
2554,鶴見区,106188,51559,54629,41652,2004-07-01
2555,東淀川区,180502,89981,90521,89696,2004-07-01
2556,住之江区,131937,63644,68293,55036,2004-07-01
2557,住吉区,159837,75364,84473,73147,2004-07-01
2558,東住吉区,136237,64684,71553,60412,2004-07-01
2559,平野区,201276,96432,104844,83140,2004-07-01
2560,阿倍野区,106519,49497,57022,47233,2004-07-01
2561,淀川区,168240,83431,84809,84820,2004-07-01
2562,西成区,135334,79053,56281,79568,2004-07-01
2563,浪速区,53394,27414,25980,33334,2004-07-01
2564,大阪市,2627049,1281523,1345526,1231164,2004-07-01
2565,北区,98023,47293,50730,53057,2004-07-01
2566,都島区,99462,48535,50927,45870,2004-07-01
2567,福島区,59234,28105,31129,28509,2004-07-01
2568,此花区,64694,31569,33125,28071,2004-07-01
2569,西淀川区,95702,47461,48241,40746,2004-07-01
2570,西区,70503,33502,37001,38978,2004-07-01
2571,港区,83898,41163,42735,37781,2004-07-01
2572,大正区,74004,36627,37377,31228,2004-07-01
2573,天王寺区,62304,29037,33267,29625,2004-07-01
2574,中央区,63969,29638,34331,37208,2004-07-01
2575,生野区,139914,66764,73150,61300,2004-08-01
2576,旭区,96386,46192,50194,43903,2004-08-01
2577,城東区,160128,76722,83406,70880,2004-08-01
2578,鶴見区,106253,51579,54674,41677,2004-08-01
2579,阿倍野区,106465,49473,56992,47225,2004-08-01
2580,住吉区,159720,75299,84421,73099,2004-08-01
2581,東住吉区,136119,64623,71496,60393,2004-08-01
2582,平野区,201197,96376,104821,83179,2004-08-01
2583,西成区,135218,79018,56200,79609,2004-08-01
2584,東成区,79201,37757,41444,36074,2004-08-01
2585,住之江区,131912,63623,68289,55041,2004-08-01
2586,東淀川区,180439,89947,90492,89691,2004-08-01
2587,淀川区,168216,83405,84811,84845,2004-08-01
2588,西淀川区,95675,47441,48234,40734,2004-08-01
2589,北区,98126,47341,50785,53130,2004-08-01
2590,都島区,99460,48528,50932,45911,2004-08-01
2591,福島区,59241,28106,31135,28545,2004-08-01
2592,此花区,64639,31533,33106,28070,2004-08-01
2593,中央区,64073,29686,34387,37370,2004-08-01
2594,大阪市,2626631,1281193,1345438,1231794,2004-08-01
2595,港区,83819,41117,42702,37764,2004-08-01
2596,大正区,73943,36591,37352,31238,2004-08-01
2597,天王寺区,62472,29110,33362,29758,2004-08-01
2598,浪速区,53321,27369,25952,33200,2004-08-01
2599,西区,70694,33593,37101,39158,2004-08-01
2600,生野区,139635,66631,73004,61304,2004-09-01
2601,旭区,96255,46122,50133,43852,2004-09-01
2602,城東区,160148,76723,83425,70869,2004-09-01
2603,鶴見区,106336,51607,54729,41747,2004-09-01
2604,阿倍野区,106415,49450,56965,47232,2004-09-01
2605,住吉区,159510,75189,84321,73088,2004-09-01
2606,東住吉区,135953,64539,71414,60348,2004-09-01
2607,平野区,201183,96350,104833,83236,2004-09-01
2608,西成区,134957,78898,56059,79617,2004-09-01
2609,東成区,79184,37742,41442,36128,2004-09-01
2610,住之江区,131834,63576,68258,55067,2004-09-01
2611,東淀川区,180243,89848,90395,89658,2004-09-01
2612,淀川区,168047,83308,84739,84849,2004-09-01
2613,西淀川区,95614,47404,48210,40723,2004-09-01
2614,北区,98079,47316,50763,53122,2004-09-01
2615,都島区,99812,48693,51119,46146,2004-09-01
2616,福島区,59310,28137,31173,28575,2004-09-01
2617,此花区,64629,31518,33111,28086,2004-09-01
2618,中央区,63892,29602,34290,37489,2004-09-01
2619,大阪市,2625030,1280277,1344753,1232446,2004-09-01
2620,港区,83645,41025,42620,37705,2004-09-01
2621,大正区,73917,36572,37345,31259,2004-09-01
2622,天王寺区,62417,29080,33337,29770,2004-09-01
2623,浪速区,53144,27270,25874,33194,2004-09-01
2624,西区,70871,33677,37194,39382,2004-09-01
2625,生野区,139509,66571,72938,61341,2004-10-01
2626,旭区,96119,46049,50070,43807,2004-10-01
2627,城東区,160154,76717,83437,70846,2004-10-01
2628,鶴見区,106730,51787,54943,41968,2004-10-01
2629,阿倍野区,106369,49430,56939,47216,2004-10-01
2630,住吉区,159483,75166,84317,73084,2004-10-01
2631,東住吉区,135840,64480,71360,60317,2004-10-01
2632,平野区,201147,96314,104833,83242,2004-10-01
2633,西成区,134855,78872,55983,79650,2004-10-01
2634,東成区,79078,37686,41392,36068,2004-10-01
2635,住之江区,131740,63521,68219,55057,2004-10-01
2636,東淀川区,180124,89787,90337,89566,2004-10-01
2637,淀川区,167882,83212,84670,84789,2004-10-01
2638,西淀川区,95637,47409,48228,40715,2004-10-01
2639,北区,98060,47305,50755,53172,2004-10-01
2640,都島区,99965,48762,51203,46250,2004-10-01
2641,福島区,59419,28187,31232,28643,2004-10-01
2642,此花区,64516,31453,33063,28056,2004-10-01
2643,中央区,64146,29720,34426,37759,2004-10-01
2644,大阪市,2624775,1280023,1344752,1232982,2004-10-01
2645,港区,83564,40979,42585,37628,2004-10-01
2646,大正区,73831,36524,37307,31232,2004-10-01
2647,天王寺区,62550,29136,33414,29843,2004-10-01
2648,浪速区,53084,27231,25853,33237,2004-10-01
2649,西区,70973,33725,37248,39496,2004-10-01
2650,生野区,139497,66565,72932,61361,2004-11-01
2651,旭区,96036,46001,50035,43778,2004-11-01
2652,城東区,160139,76702,83437,70776,2004-11-01
2653,鶴見区,106942,51878,55064,42082,2004-11-01
2654,阿倍野区,106745,49606,57139,47409,2004-11-01
2655,住吉区,159486,75156,84330,73052,2004-11-01
2656,東住吉区,135690,64404,71286,60230,2004-11-01
2657,平野区,201084,96265,104819,83288,2004-11-01
2658,西成区,134704,78816,55888,79543,2004-11-01
2659,東成区,79059,37671,41388,36092,2004-11-01
2660,住之江区,131690,63487,68203,55069,2004-11-01
2661,東淀川区,179991,89718,90273,89506,2004-11-01
2662,淀川区,167839,83178,84661,84489,2004-11-01
2663,西淀川区,95640,47404,48236,40711,2004-11-01
2664,北区,98030,47289,50741,53216,2004-11-01
2665,都島区,100043,48794,51249,46329,2004-11-01
2666,福島区,59458,28203,31255,28700,2004-11-01
2667,此花区,64466,31419,33047,28031,2004-11-01
2668,中央区,64445,29858,34587,37976,2004-11-01
2669,大阪市,2625023,1280002,1345021,1233061,2004-11-01
2670,港区,83478,40930,42548,37480,2004-11-01
2671,大正区,73781,36493,37288,31213,2004-11-01
2672,天王寺区,62555,29134,33421,29856,2004-11-01
2673,浪速区,53151,27258,25893,33272,2004-11-01
2674,西区,71074,33773,37301,39602,2004-11-01
2675,生野区,139331,66486,72845,61354,2004-12-01
2676,旭区,95943,45949,49994,43769,2004-12-01
2677,城東区,160263,76752,83511,70881,2004-12-01
2678,鶴見区,107138,51961,55177,42178,2004-12-01
2679,阿倍野区,106828,49646,57182,47424,2004-12-01
2680,住吉区,159402,75106,84296,73023,2004-12-01
2681,東住吉区,135523,64320,71203,60175,2004-12-01
2682,平野区,201031,96221,104810,83265,2004-12-01
2683,西成区,134423,78685,55738,79346,2004-12-01
2684,東成区,78941,37608,41333,36068,2004-12-01
2685,住之江区,131851,63556,68295,55182,2004-12-01
2686,東淀川区,179788,89615,90173,89445,2004-12-01
2687,淀川区,167839,83164,84675,84344,2004-12-01
2688,西淀川区,95611,47383,48228,40699,2004-12-01
2689,北区,98136,47338,50798,53291,2004-12-01
2690,都島区,100046,48789,51257,46359,2004-12-01
2691,福島区,59627,28281,31346,28780,2004-12-01
2692,此花区,64493,31423,33070,28043,2004-12-01
2693,中央区,64444,29858,34586,38109,2004-12-01
2694,大阪市,2624948,1279815,1345133,1233267,2004-12-01
2695,港区,83309,40841,42468,37412,2004-12-01
2696,大正区,73727,36460,37267,30986,2004-12-01
2697,天王寺区,62920,29299,33621,30054,2004-12-01
2698,浪速区,53147,27248,25899,33336,2004-12-01
2699,西区,71187,33826,37361,39744,2004-12-01
2700,生野区,139211,66429,72782,61357,2005-01-01
2701,旭区,95820,45883,49937,43740,2005-01-01
2702,城東区,160327,76774,83553,70880,2005-01-01
2703,鶴見区,107126,51943,55183,42185,2005-01-01
2704,阿倍野区,106892,49676,57216,47387,2005-01-01
2705,住吉区,159339,75066,84273,72994,2005-01-01
2706,東住吉区,135409,64261,71148,60148,2005-01-01
2707,平野区,200882,96131,104751,83210,2005-01-01
2708,西成区,134243,78612,55631,79151,2005-01-01
2709,東成区,78925,37595,41330,36069,2005-01-01
2710,住之江区,131821,63532,68289,55166,2005-01-01
2711,東淀川区,179595,89517,90078,89367,2005-01-01
2712,淀川区,167829,83146,84683,84333,2005-01-01
2713,西淀川区,95516,47329,48187,40575,2005-01-01
2714,北区,98228,47381,50847,53386,2005-01-01
2715,都島区,100058,48789,51269,46203,2005-01-01
2716,福島区,59686,28307,31379,28799,2005-01-01
2717,此花区,64476,31405,33071,27963,2005-01-01
2718,中央区,64516,29891,34625,38262,2005-01-01
2719,大阪市,2624348,1279390,1344958,1232927,2005-01-01
2720,港区,83212,40787,42425,37351,2005-01-01
2721,大正区,73697,36440,37257,30988,2005-01-01
2722,天王寺区,63022,29341,33681,30127,2005-01-01
2723,浪速区,53208,27271,25937,33367,2005-01-01
2724,西区,71310,33884,37426,39919,2005-01-01
2725,生野区,139173,66412,72761,61321,2005-02-01
2726,旭区,95717,45826,49891,43680,2005-02-01
2727,城東区,160203,76706,83497,70829,2005-02-01
2728,鶴見区,107110,51923,55187,42190,2005-02-01
2729,阿倍野区,106977,49717,57260,47413,2005-02-01
2730,住吉区,159318,75045,84273,72945,2005-02-01
2731,東住吉区,135300,64205,71095,60126,2005-02-01
2732,平野区,200758,96053,104705,83210,2005-02-01
2733,西成区,133920,78455,55465,79066,2005-02-01
2734,東成区,78865,37560,41305,36056,2005-02-01
2735,住之江区,131716,63472,68244,55144,2005-02-01
2736,東淀川区,179417,89427,89990,89217,2005-02-01
2737,淀川区,167761,83098,84663,84289,2005-02-01
2738,西淀川区,95530,47329,48201,40547,2005-02-01
2739,北区,98269,47399,50870,53375,2005-02-01
2740,都島区,100000,48754,51246,46206,2005-02-01
2741,福島区,59669,28297,31372,28813,2005-02-01
2742,此花区,64418,31367,33051,27941,2005-02-01
2743,中央区,64650,29953,34697,38395,2005-02-01
2744,大阪市,2623105,1278638,1344467,1232647,2005-02-01
2745,港区,83124,40737,42387,37336,2005-02-01
2746,大正区,73618,36395,37223,30951,2005-02-01
2747,天王寺区,62980,29316,33664,30156,2005-02-01
2748,浪速区,53201,27260,25941,33374,2005-02-01
2749,西区,71411,33932,37479,40067,2005-02-01
2750,東成区,78825,37535,41290,36070,2005-03-01
2751,生野区,139061,66358,72703,61302,2005-03-01
2752,旭区,95614,45769,49845,43631,2005-03-01
2753,城東区,160163,76679,83484,70829,2005-03-01
2754,鶴見区,107186,51948,55238,42232,2005-03-01
2755,住之江区,131631,63422,68209,55128,2005-03-01
2756,住吉区,159351,75050,84301,72965,2005-03-01
2757,東住吉区,135207,64156,71051,60105,2005-03-01
2758,平野区,200720,96017,104703,83228,2005-03-01
2759,東淀川区,179147,89290,89857,89134,2005-03-01
2760,阿倍野区,107035,49745,57290,47451,2005-03-01
2761,淀川区,167888,83148,84740,84310,2005-03-01
2762,西成区,133716,78369,55347,78957,2005-03-01
2763,浪速区,53274,27289,25985,33446,2005-03-01
2764,大阪市,2622879,1278390,1344489,1232982,2005-03-01
2765,北区,98262,47393,50869,53255,2005-03-01
2766,都島区,100062,48778,51284,46278,2005-03-01
2767,福島区,59679,28300,31379,28824,2005-03-01
2768,此花区,64146,31225,32921,27814,2005-03-01
2769,西淀川区,95553,47334,48219,40552,2005-03-01
2770,西区,71480,33965,37515,40228,2005-03-01
2771,港区,83290,40812,42478,37461,2005-03-01
2772,大正区,73540,36350,37190,30925,2005-03-01
2773,天王寺区,63086,29360,33726,30221,2005-03-01
2774,中央区,64963,30098,34865,38636,2005-03-01
2775,生野区,138884,66274,72610,61331,2005-04-01
2776,旭区,95397,45658,49739,43533,2005-04-01
2777,城東区,160197,76686,83511,70973,2005-04-01
2778,鶴見区,107178,51932,55246,42300,2005-04-01
2779,阿倍野区,107039,49748,57291,47507,2005-04-01
2780,住吉区,158973,74861,84112,72791,2005-04-01
2781,東住吉区,134969,64038,70931,59984,2005-04-01
2782,平野区,200587,95934,104653,83310,2005-04-01
2783,西成区,133561,78310,55251,78893,2005-04-01
2784,東成区,78973,37599,41374,36154,2005-04-01
2785,住之江区,131269,63238,68031,54921,2005-04-01
2786,東淀川区,178799,89115,89684,89242,2005-04-01
2787,淀川区,168534,83454,85080,84827,2005-04-01
2788,西淀川区,95374,47239,48135,40531,2005-04-01
2789,北区,98723,47614,51109,53675,2005-04-01
2790,都島区,99857,48672,51185,46291,2005-04-01
2791,福島区,59704,28310,31394,28836,2005-04-01
2792,此花区,63984,31136,32848,27803,2005-04-01
2793,中央区,65411,30305,35106,39082,2005-04-01
2794,大阪市,2622773,1278203,1344570,1235048,2005-04-01
2795,港区,83260,40791,42469,37525,2005-04-01
2796,大正区,73462,36306,37156,30895,2005-04-01
2797,天王寺区,63474,29536,33938,30459,2005-04-01
2798,浪速区,53431,27362,26069,33581,2005-04-01
2799,西区,71733,34085,37648,40604,2005-04-01
2800,生野区,138960,66311,72649,61481,2005-05-01
2801,旭区,95456,45678,49778,43622,2005-05-01
2802,城東区,160680,76909,83771,71271,2005-05-01
2803,鶴見区,107305,51982,55323,42416,2005-05-01
2804,阿倍野区,107582,50002,57580,47839,2005-05-01
2805,住吉区,159204,74960,84244,73013,2005-05-01
2806,東住吉区,135009,64052,70957,60069,2005-05-01
2807,平野区,200691,95965,104726,83491,2005-05-01
2808,西成区,133513,78315,55198,78954,2005-05-01
2809,東成区,79066,37638,41428,36265,2005-05-01
2810,住之江区,131222,63206,68016,54961,2005-05-01
2811,東淀川区,179071,89249,89822,89543,2005-05-01
2812,淀川区,168899,83621,85278,85101,2005-05-01
2813,西淀川区,95513,47301,48212,40653,2005-05-01
2814,北区,99402,47939,51463,54211,2005-05-01
2815,都島区,99956,48715,51241,46408,2005-05-01
2816,福島区,59857,28381,31476,29006,2005-05-01
2817,此花区,64035,31151,32884,27854,2005-05-01
2818,中央区,65862,30514,35348,39437,2005-05-01
2819,大阪市,2627653,1280433,1347220,1239652,2005-05-01
2820,港区,83273,40791,42482,37623,2005-05-01
2821,大正区,73447,36292,37155,30950,2005-05-01
2822,天王寺区,63715,29643,34072,30647,2005-05-01
2823,浪速区,53807,27546,26261,33821,2005-05-01
2824,西区,72128,34272,37856,41016,2005-05-01
2825,生野区,138842,66255,72587,61535,2005-06-01
2826,旭区,95411,45649,49762,43656,2005-06-01
2827,城東区,160822,76968,83854,71394,2005-06-01
2828,鶴見区,107366,51999,55367,42468,2005-06-01
2829,阿倍野区,107478,49954,57524,47778,2005-06-01
2830,住吉区,159189,74942,84247,73012,2005-06-01
2831,東住吉区,135252,64162,71090,60267,2005-06-01
2832,平野区,200674,95939,104735,83555,2005-06-01
2833,西成区,133264,78201,55063,78945,2005-06-01
2834,東成区,79059,37628,41431,36284,2005-06-01
2835,住之江区,131069,63123,67946,54916,2005-06-01
2836,東淀川区,178904,89164,89740,89526,2005-06-01
2837,淀川区,169154,83734,85420,85295,2005-06-01
2838,西淀川区,95564,47319,48245,40715,2005-06-01
2839,北区,99643,48054,51589,54445,2005-06-01
2840,都島区,99995,48727,51268,46424,2005-06-01
2841,福島区,59938,28417,31521,29092,2005-06-01
2842,此花区,64021,31135,32886,27857,2005-06-01
2843,中央区,66172,30657,35515,39717,2005-06-01
2844,大阪市,2628577,1280731,1347846,1241495,2005-06-01
2845,港区,83206,40751,42455,37640,2005-06-01
2846,大正区,73453,36289,37164,30986,2005-06-01
2847,天王寺区,63841,29696,34145,30756,2005-06-01
2848,浪速区,53880,27576,26304,33933,2005-06-01
2849,西区,72380,34392,37988,41299,2005-06-01
2850,東成区,79064,37624,41440,36295,2005-07-01
2851,生野区,138749,66210,72539,61562,2005-07-01
2852,旭区,95419,45645,49774,43658,2005-07-01
2853,城東区,160871,76983,83888,71413,2005-07-01
2854,鶴見区,107348,51979,55369,42459,2005-07-01
2855,住之江区,130989,63075,67914,54910,2005-07-01
2856,住吉区,159097,74888,84209,72992,2005-07-01
2857,東住吉区,135307,64184,71123,60350,2005-07-01
2858,平野区,200750,95956,104794,83657,2005-07-01
2859,東淀川区,178741,89081,89660,89503,2005-07-01
2860,阿倍野区,107427,49932,57495,47748,2005-07-01
2861,淀川区,169225,83755,85470,85315,2005-07-01
2862,西成区,133213,78204,55009,78978,2005-07-01
2863,浪速区,53909,27583,26326,34053,2005-07-01
2864,大阪市,2628831,1280734,1348097,1242471,2005-07-01
2865,北区,99834,48144,51690,54628,2005-07-01
2866,都島区,99982,48715,51267,46451,2005-07-01
2867,福島区,60000,28444,31556,29129,2005-07-01
2868,此花区,64029,31129,32900,27863,2005-07-01
2869,西淀川区,95584,47322,48262,40732,2005-07-01
2870,西区,72392,34397,37995,41423,2005-07-01
2871,港区,83340,40811,42529,37701,2005-07-01
2872,大正区,73386,36250,37136,30984,2005-07-01
2873,天王寺区,63854,29697,34157,30805,2005-07-01
2874,中央区,66321,30726,35595,39862,2005-07-01
2875,生野区,138760,66216,72544,61615,2005-08-01
2876,旭区,95372,45615,49757,43668,2005-08-01
2877,城東区,160970,77022,83948,71460,2005-08-01
2878,鶴見区,107389,51986,55403,42477,2005-08-01
2879,阿倍野区,107504,49969,57535,47810,2005-08-01
2880,住吉区,159031,74846,84185,72924,2005-08-01
2881,東住吉区,135219,64137,71082,60346,2005-08-01
2882,平野区,200808,95965,104843,83724,2005-08-01
2883,西成区,133051,78141,54910,78990,2005-08-01
2884,東成区,78985,37581,41404,36269,2005-08-01
2885,住之江区,130817,62983,67834,54883,2005-08-01
2886,東淀川区,178570,88994,89576,89446,2005-08-01
2887,淀川区,169281,83769,85512,85194,2005-08-01
2888,西淀川区,95615,47331,48284,40757,2005-08-01
2889,北区,99958,48202,51756,54732,2005-08-01
2890,都島区,99951,48694,51257,46473,2005-08-01
2891,福島区,60058,28470,31588,29181,2005-08-01
2892,此花区,64028,31119,32909,27861,2005-08-01
2893,中央区,66523,30820,35703,40096,2005-08-01
2894,大阪市,2628956,1280659,1348297,1243125,2005-08-01
2895,港区,83342,40805,42537,37731,2005-08-01
2896,大正区,73337,36220,37117,30965,2005-08-01
2897,天王寺区,63921,29723,34198,30844,2005-08-01
2898,浪速区,53951,27596,26355,34116,2005-08-01
2899,西区,72515,34455,38060,41563,2005-08-01
2900,東成区,78949,37558,41391,36282,2005-09-01
2901,生野区,138623,66151,72472,61633,2005-09-01
2902,旭区,95314,45580,49734,43649,2005-09-01
2903,城東区,160996,77026,83970,71500,2005-09-01
2904,鶴見区,107431,51995,55436,42502,2005-09-01
2905,住之江区,130722,62928,67794,54895,2005-09-01
2906,住吉区,159023,74832,84191,72945,2005-09-01
2907,東住吉区,135152,64100,71052,60382,2005-09-01
2908,平野区,200801,95943,104858,83784,2005-09-01
2909,東淀川区,178430,88922,89508,89411,2005-09-01
2910,阿倍野区,107486,49961,57525,47798,2005-09-01
2911,淀川区,169314,83772,85542,85240,2005-09-01
2912,西成区,132879,78072,54807,78990,2005-09-01
2913,浪速区,54111,27670,26441,34231,2005-09-01
2914,大阪市,2629142,1280617,1348525,1244231,2005-09-01
2915,北区,100208,48321,51887,54939,2005-09-01
2916,都島区,99952,48688,51264,46524,2005-09-01
2917,福島区,60063,28470,31593,29216,2005-09-01
2918,此花区,64080,31134,32946,27900,2005-09-01
2919,西淀川区,95657,47345,48312,40798,2005-09-01
2920,西区,72577,34485,38092,41718,2005-09-01
2921,港区,83293,40774,42519,37721,2005-09-01
2922,大正区,73304,36198,37106,30980,2005-09-01
2923,天王寺区,63999,29754,34245,30902,2005-09-01
2924,中央区,66778,30938,35840,40291,2005-09-01
2925,東成区,78929,37542,41387,36304,2005-10-01
2926,生野区,138564,66123,72441,61635,2005-10-01
2927,旭区,95204,45520,49684,43628,2005-10-01
2928,城東区,160925,76983,83942,71458,2005-10-01
2929,鶴見区,107419,51977,55442,42514,2005-10-01
2930,住之江区,130627,62873,67754,54906,2005-10-01
2931,住吉区,158999,74810,84189,72959,2005-10-01
2932,東住吉区,135016,64031,70985,60347,2005-10-01
2933,平野区,200678,95866,104812,83842,2005-10-01
2934,東淀川区,178343,88877,89466,89430,2005-10-01
2935,阿倍野区,107354,49901,57453,47795,2005-10-01
2936,淀川区,169222,83713,85509,85217,2005-10-01
2937,西成区,132767,78039,54728,78995,2005-10-01
2938,浪速区,54174,27694,26480,34279,2005-10-01
2939,大阪市,2628811,1280325,1348486,1245012,2005-10-01
2940,北区,100385,48404,51981,55081,2005-10-01
2941,都島区,99831,48623,51208,46499,2005-10-01
2942,福島区,60959,28893,32066,29624,2005-10-01
2943,此花区,63809,30993,32816,27815,2005-10-01
2944,西淀川区,95662,47341,48321,40825,2005-10-01
2945,西区,72591,34491,38100,41808,2005-10-01
2946,港区,83191,40718,42473,37702,2005-10-01
2947,大正区,73207,36144,37063,30965,2005-10-01
2948,天王寺区,64137,29813,34324,30965,2005-10-01
2949,中央区,66818,30956,35862,40419,2005-10-01
2950,東成区,78952,37564,41388,36343,2005-11-01
2951,生野区,138614,66146,72468,61693,2005-11-01
2952,旭区,95191,45509,49682,43637,2005-11-01
2953,城東区,160886,76967,83919,71487,2005-11-01
2954,鶴見区,107501,52000,55501,42580,2005-11-01
2955,住之江区,130575,62821,67754,54974,2005-11-01
2956,住吉区,159076,74836,84240,72956,2005-11-01
2957,東住吉区,134958,63992,70966,60321,2005-11-01
2958,平野区,200729,95885,104844,83931,2005-11-01
2959,東淀川区,178377,88868,89509,89504,2005-11-01
2960,阿倍野区,107350,49896,57454,47780,2005-11-01
2961,西成区,132615,77944,54671,78969,2005-11-01
2962,淀川区,169617,83913,85704,85398,2005-11-01
2963,浪速区,54377,27821,26556,34377,2005-11-01
2964,西淀川区,95679,47336,48343,40864,2005-11-01
2965,大阪市,2630247,1280945,1349302,1246331,2005-11-01
2966,北区,100548,48453,52095,55227,2005-11-01
2967,福島区,61091,28962,32129,29717,2005-11-01
2968,此花区,63833,31012,32821,27848,2005-11-01
2969,都島区,99794,48590,51204,46517,2005-11-01
2970,西区,72755,34591,38164,41859,2005-11-01
2971,港区,83204,40722,42482,37753,2005-11-01
2972,大正区,73218,36143,37075,31014,2005-11-01
2973,天王寺区,64352,29934,34418,31044,2005-11-01
2974,中央区,66955,31040,35915,40538,2005-11-01
2975,城東区,160880,76960,83920,71538,2005-12-01
2976,東成区,78988,37589,41399,36412,2005-12-01
2977,生野区,138395,66064,72331,61656,2005-12-01
2978,旭区,95150,45486,49664,43614,2005-12-01
2979,鶴見区,107537,52002,55535,42615,2005-12-01
2980,東淀川区,178218,88760,89458,89476,2005-12-01
2981,住之江区,130570,62810,67760,55030,2005-12-01
2982,住吉区,159019,74802,84217,73013,2005-12-01
2983,東住吉区,134823,63934,70889,60313,2005-12-01
2984,平野区,200733,95847,104886,84003,2005-12-01
2985,阿倍野区,107278,49855,57423,47752,2005-12-01
2986,淀川区,169599,83915,85684,85458,2005-12-01
2987,西成区,132407,77804,54603,78941,2005-12-01
2988,浪速区,54489,27869,26620,34497,2005-12-01
2989,大阪市,2630072,1280683,1349389,1247177,2005-12-01
2990,北区,100696,48538,52158,55369,2005-12-01
2991,都島区,99801,48550,51251,46545,2005-12-01
2992,福島区,61146,28992,32154,29777,2005-12-01
2993,此花区,63777,31007,32770,27850,2005-12-01
2994,西淀川区,95642,47313,48329,40871,2005-12-01
2995,西区,72976,34660,38316,41952,2005-12-01
2996,港区,83198,40713,42485,37783,2005-12-01
2997,大正区,73159,36113,37046,30987,2005-12-01
2998,天王寺区,64527,30008,34519,31125,2005-12-01
2999,中央区,67064,31092,35972,40600,2005-12-01
3000,東成区,78964,37559,41405,36403,2006-01-01
3001,旭区,95030,45430,49600,43576,2006-01-01
3002,城東区,160929,76984,83945,71557,2006-01-01
3003,鶴見区,107536,52014,55522,42658,2006-01-01
3004,阿倍野区,107164,49818,57346,47718,2006-01-01
3005,住吉区,159015,74821,84194,73035,2006-01-01
3006,東淀川区,178045,88661,89384,89424,2006-01-01
3007,東住吉区,134682,63860,70822,60283,2006-01-01
3008,平野区,200644,95774,104870,84067,2006-01-01
3009,西成区,132142,77632,54510,78858,2006-01-01
3010,住之江区,130530,62787,67743,55058,2006-01-01
3011,淀川区,169563,83869,85694,85470,2006-01-01
3012,生野区,138290,66012,72278,61653,2006-01-01
3013,浪速区,54721,27954,26767,34659,2006-01-01
3014,西淀川区,95585,47258,48327,40839,2006-01-01
3015,北区,100921,48649,52272,55570,2006-01-01
3016,都島区,99851,48573,51278,46570,2006-01-01
3017,福島区,61212,29014,32198,29805,2006-01-01
3018,此花区,63780,31015,32765,27890,2006-01-01
3019,大阪市,2629550,1280245,1349305,1247617,2006-01-01
3020,西区,73073,34692,38381,41992,2006-01-01
3021,港区,83108,40669,42439,37777,2006-01-01
3022,大正区,73099,36085,37014,30962,2006-01-01
3023,天王寺区,64544,30025,34519,31149,2006-01-01
3024,中央区,67122,31090,36032,40644,2006-01-01
3025,東成区,78976,37573,41403,36423,2006-02-01
3026,旭区,94937,45367,49570,43462,2006-02-01
3027,城東区,160931,76965,83966,71577,2006-02-01
3028,鶴見区,107560,52040,55520,42692,2006-02-01
3029,阿倍野区,107056,49746,57310,47653,2006-02-01
3030,住吉区,159003,74832,84171,73040,2006-02-01
3031,東住吉区,134565,63799,70766,60244,2006-02-01
3032,平野区,200621,95744,104877,84055,2006-02-01
3033,西成区,131823,77393,54430,78733,2006-02-01
3034,東淀川区,177977,88597,89380,89441,2006-02-01
3035,住之江区,130473,62739,67734,55062,2006-02-01
3036,淀川区,169453,83791,85662,85425,2006-02-01
3037,生野区,138198,66009,72189,61653,2006-02-01
3038,浪速区,54730,27956,26774,34740,2006-02-01
3039,北区,101312,48847,52465,55816,2006-02-01
3040,都島区,99785,48517,51268,46567,2006-02-01
3041,福島区,61201,29014,32187,29852,2006-02-01
3042,此花区,63814,31029,32785,27923,2006-02-01
3043,中央区,67244,31135,36109,40671,2006-02-01
3044,大阪市,2629129,1279832,1349297,1247834,2006-02-01
3045,港区,83083,40649,42434,37789,2006-02-01
3046,西区,73191,34746,38445,42011,2006-02-01
3047,天王寺区,64559,30032,34527,31180,2006-02-01
3048,西淀川区,95566,47243,48323,40855,2006-02-01
3049,大正区,73071,36069,37002,30970,2006-02-01
3050,東淀川区,177808,88462,89346,89399,2006-03-01
3051,平野区,200686,95756,104930,84079,2006-03-01
3052,東住吉区,134434,63715,70719,60218,2006-03-01
3053,住吉区,159000,74841,84159,73047,2006-03-01
3054,阿倍野区,106983,49691,57292,47620,2006-03-01
3055,鶴見区,107589,52043,55546,42728,2006-03-01
3056,城東区,160796,76868,83928,71584,2006-03-01
3057,旭区,94809,45299,49510,43445,2006-03-01
3058,生野区,138079,65972,72107,61585,2006-03-01
3059,東成区,78959,37582,41377,36464,2006-03-01
3060,西成区,131714,77190,54524,78435,2006-03-01
3061,住之江区,130377,62674,67703,55019,2006-03-01
3062,淀川区,169550,83854,85696,85511,2006-03-01
3063,浪速区,54825,28023,26802,34835,2006-03-01
3064,西淀川区,95597,47249,48348,40910,2006-03-01
3065,大阪市,2629043,1279416,1349627,1248036,2006-03-01
3066,北区,101461,48844,52617,55804,2006-03-01
3067,福島区,61213,29017,32196,29875,2006-03-01
3068,此花区,63811,31037,32774,27934,2006-03-01
3069,都島区,99708,48478,51230,46540,2006-03-01
3070,西区,73356,34805,38551,42047,2006-03-01
3071,港区,83083,40653,42430,37837,2006-03-01
3072,大正区,73019,36022,36997,30993,2006-03-01
3073,天王寺区,64598,30048,34550,31227,2006-03-01
3074,中央区,67588,31293,36295,40900,2006-03-01
3075,城東区,161030,76958,84072,71883,2006-04-01
3076,東成区,79010,37621,41389,36597,2006-04-01
3077,生野区,137893,65877,72016,61639,2006-04-01
3078,旭区,94548,45163,49385,43448,2006-04-01
3079,鶴見区,107413,51925,55488,42778,2006-04-01
3080,東淀川区,177590,88305,89285,89662,2006-04-01
3081,住之江区,130077,62521,67556,55078,2006-04-01
3082,住吉区,158606,74616,83990,73058,2006-04-01
3083,東住吉区,134364,63647,70717,60309,2006-04-01
3084,平野区,200422,95560,104862,84187,2006-04-01
3085,阿倍野区,106789,49581,57208,47559,2006-04-01
3086,淀川区,169927,83963,85964,85976,2006-04-01
3087,西成区,131507,77003,54504,78359,2006-04-01
3088,浪速区,55359,28235,27124,35087,2006-04-01
3089,大阪市,2629663,1278864,1350799,1251715,2006-04-01
3090,北区,101548,48797,52751,56096,2006-04-01
3091,都島区,100393,48784,51609,46987,2006-04-01
3092,福島区,61262,28997,32265,29966,2006-04-01
3093,此花区,63780,30979,32801,27992,2006-04-01
3094,西淀川区,95618,47266,48352,41022,2006-04-01
3095,西区,73892,34997,38895,42442,2006-04-01
3096,港区,83005,40600,42405,37926,2006-04-01
3097,大正区,72895,35920,36975,30979,2006-04-01
3098,天王寺区,64642,30035,34607,31310,2006-04-01
3099,中央区,68093,31514,36579,41375,2006-04-01
3100,生野区,137932,65910,72022,61727,2006-05-01
3101,旭区,94562,45143,49419,43502,2006-05-01
3102,城東区,161214,77066,84148,72035,2006-05-01
3103,鶴見区,107476,51963,55513,42882,2006-05-01
3104,阿倍野区,107086,49749,57337,47805,2006-05-01
3105,住吉区,158908,74738,84170,73294,2006-05-01
3106,東住吉区,134350,63650,70700,60390,2006-05-01
3107,平野区,200582,95685,104897,84334,2006-05-01
3108,西成区,131470,76986,54484,78495,2006-05-01
3109,東成区,79180,37686,41494,36739,2006-05-01
3110,住之江区,130102,62544,67558,55227,2006-05-01
3111,東淀川区,177865,88465,89400,90015,2006-05-01
3112,福島区,61489,29108,32381,30141,2006-05-01
3113,西淀川区,95900,47428,48472,41228,2006-05-01
3114,北区,102069,49055,53014,56498,2006-05-01
3115,都島区,100725,48959,51766,47123,2006-05-01
3116,淀川区,170291,84168,86123,86316,2006-05-01
3117,此花区,63837,30999,32838,28056,2006-05-01
3118,中央区,68745,31852,36893,41821,2006-05-01
3119,大阪市,2634843,1281562,1353281,1256276,2006-05-01
3120,港区,83098,40626,42472,38036,2006-05-01
3121,大正区,72934,35935,36999,31042,2006-05-01
3122,天王寺区,64848,30156,34692,31442,2006-05-01
3123,浪速区,55865,28490,27375,35388,2006-05-01
3124,西区,74315,35201,39114,42740,2006-05-01
3125,東成区,79208,37650,41558,36781,2006-06-01
3126,生野区,137843,65881,71962,61783,2006-06-01
3127,旭区,94457,45102,49355,43508,2006-06-01
3128,城東区,161328,77107,84221,72162,2006-06-01
3129,鶴見区,107562,52002,55560,42904,2006-06-01
3130,住之江区,129906,62445,67461,55230,2006-06-01
3131,住吉区,158815,74711,84104,73339,2006-06-01
3132,東住吉区,134381,63648,70733,60403,2006-06-01
3133,平野区,200580,95704,104876,84365,2006-06-01
3134,東淀川区,177824,88448,89376,90063,2006-06-01
3135,阿倍野区,107057,49717,57340,47848,2006-06-01
3136,淀川区,170308,84178,86130,86426,2006-06-01
3137,西成区,131133,76749,54384,78446,2006-06-01
3138,浪速区,56104,28594,27510,35575,2006-06-01
3139,大阪市,2634942,1281527,1353415,1257833,2006-06-01
3140,北区,102169,49092,53077,56671,2006-06-01
3141,都島区,100713,48972,51741,47194,2006-06-01
3142,福島区,61590,29163,32427,30245,2006-06-01
3143,此花区,63797,30976,32821,28063,2006-06-01
3144,西淀川区,95974,47461,48513,41325,2006-06-01
3145,西区,74500,35314,39186,42885,2006-06-01
3146,港区,83031,40612,42419,38069,2006-06-01
3147,大正区,72929,35955,36974,31075,2006-06-01
3148,天王寺区,64764,30074,34690,31431,2006-06-01
3149,中央区,68969,31972,36997,42042,2006-06-01
3150,東成区,79218,37649,41569,36842,2006-07-01
3151,平野区,200631,95708,104923,84428,2006-07-01
3152,東住吉区,134317,63633,70684,60444,2006-07-01
3153,住吉区,158832,74729,84103,73384,2006-07-01
3154,住之江区,129746,62343,67403,55262,2006-07-01
3155,阿倍野区,107005,49698,57307,47880,2006-07-01
3156,鶴見区,107602,51987,55615,42941,2006-07-01
3157,城東区,161318,77121,84197,72213,2006-07-01
3158,旭区,94381,45058,49323,43513,2006-07-01
3159,生野区,137728,65843,71885,61820,2006-07-01
3160,東淀川区,177881,88478,89403,90146,2006-07-01
3161,西成区,130862,76575,54287,78472,2006-07-01
3162,淀川区,170255,84147,86108,86451,2006-07-01
3163,大阪市,2634528,1281251,1353277,1258987,2006-07-01
3164,北区,102372,49221,53151,56865,2006-07-01
3165,都島区,100690,48950,51740,47198,2006-07-01
3166,福島区,61619,29178,32441,30271,2006-07-01
3167,此花区,63770,30989,32781,28075,2006-07-01
3168,西淀川区,96061,47496,48565,41406,2006-07-01
3169,西区,74728,35425,39303,42993,2006-07-01
3170,港区,82994,40588,42406,38094,2006-07-01
3171,大正区,72860,35912,36948,31079,2006-07-01
3172,天王寺区,64753,30046,34707,31467,2006-07-01
3173,浪速区,56047,28570,27477,35682,2006-07-01
3174,中央区,68858,31907,36951,42061,2006-07-01
3175,東成区,79217,37650,41567,36866,2006-08-01
3176,生野区,137518,65725,71793,61805,2006-08-01
3177,旭区,94393,45066,49327,43537,2006-08-01
3178,城東区,161311,77114,84197,72220,2006-08-01
3179,鶴見区,107640,51992,55648,42960,2006-08-01
3180,住吉区,158790,74685,84105,73359,2006-08-01
3181,住之江区,129737,62342,67395,55306,2006-08-01
3182,東住吉区,134275,63632,70643,60426,2006-08-01
3183,平野区,200628,95683,104945,84490,2006-08-01
3184,東淀川区,177853,88438,89415,90204,2006-08-01
3185,阿倍野区,107062,49691,57371,47950,2006-08-01
3186,西成区,130694,76442,54252,78486,2006-08-01
3187,西淀川区,96209,47568,48641,41520,2006-08-01
3188,浪速区,56135,28609,27526,35787,2006-08-01
3189,淀川区,170277,84171,86106,86503,2006-08-01
3190,大阪市,2634725,1281199,1353526,1259851,2006-08-01
3191,北区,102439,49291,53148,57001,2006-08-01
3192,福島区,61560,29147,32413,30250,2006-08-01
3193,此花区,63762,30985,32777,28090,2006-08-01
3194,都島区,100735,48959,51776,47236,2006-08-01
3195,西区,74870,35493,39377,43008,2006-08-01
3196,港区,82902,40536,42366,38064,2006-08-01
3197,大正区,72868,35913,36955,31089,2006-08-01
3198,天王寺区,64838,30091,34747,31501,2006-08-01
3199,中央区,69012,31976,37036,42193,2006-08-01
3200,城東区,161540,77192,84348,72295,2006-09-01
3201,東成区,79202,37629,41573,36855,2006-09-01
3202,生野区,137277,65587,71690,61768,2006-09-01
3203,旭区,94540,45157,49383,43651,2006-09-01
3204,鶴見区,107624,51953,55671,42988,2006-09-01
3205,東淀川区,177686,88402,89284,90198,2006-09-01
3206,住之江区,129750,62340,67410,55335,2006-09-01
3207,住吉区,158627,74622,84005,73320,2006-09-01
3208,東住吉区,134246,63631,70615,60423,2006-09-01
3209,平野区,200720,95712,105008,84575,2006-09-01
3210,阿倍野区,107056,49666,57390,47967,2006-09-01
3211,西成区,130540,76319,54221,78470,2006-09-01
3212,淀川区,170345,84198,86147,86569,2006-09-01
3213,浪速区,56215,28662,27553,35872,2006-09-01
3214,大阪市,2635013,1281180,1353833,1260770,2006-09-01
3215,北区,102687,49405,53282,57224,2006-09-01
3216,都島区,100682,48909,51773,47298,2006-09-01
3217,福島区,61592,29147,32445,30266,2006-09-01
3218,此花区,63739,30967,32772,28106,2006-09-01
3219,西淀川区,96245,47605,48640,41556,2006-09-01
3220,西区,75040,35571,39469,43084,2006-09-01
3221,港区,82815,40486,42329,38066,2006-09-01
3222,大正区,72785,35854,36931,31090,2006-09-01
3223,天王寺区,64808,30096,34712,31484,2006-09-01
3224,中央区,69252,32070,37182,42310,2006-09-01
3225,生野区,137104,65494,71610,61727,2006-10-01
3226,旭区,94559,45154,49405,43664,2006-10-01
3227,城東区,161645,77252,84393,72418,2006-10-01
3228,鶴見区,107606,51930,55676,42947,2006-10-01
3229,阿倍野区,107019,49652,57367,47969,2006-10-01
3230,住吉区,158480,74550,83930,73304,2006-10-01
3231,東住吉区,134294,63636,70658,60476,2006-10-01
3232,平野区,200636,95657,104979,84573,2006-10-01
3233,西成区,130264,76024,54240,78150,2006-10-01
3234,東成区,79192,37655,41537,36875,2006-10-01
3235,住之江区,129627,62281,67346,55346,2006-10-01
3236,東淀川区,177542,88296,89246,90200,2006-10-01
3237,淀川区,170076,84071,86005,86472,2006-10-01
3238,西淀川区,96321,47659,48662,41617,2006-10-01
3239,北区,102811,49416,53395,57324,2006-10-01
3240,都島区,100617,48876,51741,47292,2006-10-01
3241,福島区,61601,29154,32447,30277,2006-10-01
3242,此花区,64172,31190,32982,28279,2006-10-01
3243,中央区,69285,32115,37170,42372,2006-10-01
3244,大阪市,2634944,1280924,1354020,1261113,2006-10-01
3245,港区,83380,40775,42605,38370,2006-10-01
3246,大正区,72631,35755,36876,30995,2006-10-01
3247,天王寺区,64787,30081,34706,31492,2006-10-01
3248,浪速区,56278,28707,27571,35954,2006-10-01
3249,西区,75017,35544,39473,43020,2006-10-01
3250,生野区,137043,65481,71562,61723,2006-11-01
3251,旭区,94664,45215,49449,43720,2006-11-01
3252,城東区,161885,77369,84516,72549,2006-11-01
3253,鶴見区,107676,51990,55686,43009,2006-11-01
3254,阿倍野区,107148,49715,57433,48071,2006-11-01
3255,住吉区,158383,74491,83892,73246,2006-11-01
3256,東住吉区,134292,63634,70658,60466,2006-11-01
3257,平野区,200590,95659,104931,84547,2006-11-01
3258,西成区,130080,75812,54268,77808,2006-11-01
3259,東成区,79158,37651,41507,36876,2006-11-01
3260,住之江区,129893,62420,67473,55507,2006-11-01
3261,東淀川区,177473,88275,89198,90191,2006-11-01
3262,淀川区,170081,84078,86003,86541,2006-11-01
3263,西淀川区,96379,47688,48691,41657,2006-11-01
3264,北区,102930,49428,53502,57466,2006-11-01
3265,都島区,100683,48890,51793,47319,2006-11-01
3266,福島区,61586,29162,32424,30265,2006-11-01
3267,此花区,64306,31246,33060,28365,2006-11-01
3268,中央区,69431,32192,37239,42436,2006-11-01
3269,大阪市,2636163,1281445,1354718,1261766,2006-11-01
3270,港区,83348,40767,42581,38374,2006-11-01
3271,大正区,72575,35728,36847,31003,2006-11-01
3272,天王寺区,64869,30116,34753,31526,2006-11-01
3273,浪速区,56527,28814,27713,36039,2006-11-01
3274,西区,75163,35624,39539,43062,2006-11-01
3275,生野区,136968,65423,71545,61710,2006-12-01
3276,旭区,94592,45186,49406,43699,2006-12-01
3277,城東区,161953,77426,84527,72585,2006-12-01
3278,鶴見区,107688,51989,55699,43013,2006-12-01
3279,阿倍野区,107128,49690,57438,48101,2006-12-01
3280,住吉区,158215,74379,83836,73169,2006-12-01
3281,東住吉区,134174,63556,70618,60459,2006-12-01
3282,平野区,200522,95617,104905,84565,2006-12-01
3283,西成区,129851,75644,54207,77721,2006-12-01
3284,東成区,79171,37661,41510,36908,2006-12-01
3285,住之江区,129850,62406,67444,55531,2006-12-01
3286,東淀川区,177418,88272,89146,90101,2006-12-01
3287,淀川区,170122,84094,86028,86640,2006-12-01
3288,西淀川区,96321,47665,48656,41637,2006-12-01
3289,北区,102955,49425,53530,57510,2006-12-01
3290,都島区,100716,48863,51853,47282,2006-12-01
3291,福島区,61648,29204,32444,30265,2006-12-01
3292,此花区,64331,31243,33088,28329,2006-12-01
3293,中央区,69514,32229,37285,42529,2006-12-01
3294,大阪市,2635983,1281225,1354758,1262091,2006-12-01
3295,港区,83728,40976,42752,38596,2006-12-01
3296,大正区,72482,35668,36814,30969,2006-12-01
3297,天王寺区,64858,30121,34737,31520,2006-12-01
3298,浪速区,56547,28817,27730,36160,2006-12-01
3299,西区,75231,35671,39560,43092,2006-12-01
3300,東成区,79213,37711,41502,36918,2007-01-01
3301,生野区,136879,65404,71475,61711,2007-01-01
3302,旭区,94568,45186,49382,43703,2007-01-01
3303,城東区,161815,77334,84481,72573,2007-01-01
3304,鶴見区,107784,52039,55745,43062,2007-01-01
3305,住之江区,129823,62358,67465,55513,2007-01-01
3306,住吉区,158203,74372,83831,73151,2007-01-01
3307,東住吉区,134134,63554,70580,60425,2007-01-01
3308,平野区,200520,95574,104946,84555,2007-01-01
3309,東淀川区,177344,88201,89143,90095,2007-01-01
3310,阿倍野区,107115,49672,57443,48107,2007-01-01
3311,淀川区,170049,84019,86030,86621,2007-01-01
3312,西成区,129565,75464,54101,77640,2007-01-01
3313,浪速区,56553,28809,27744,36218,2007-01-01
3314,大阪市,2635662,1280835,1354827,1262151,2007-01-01
3315,北区,103085,49482,53603,57644,2007-01-01
3316,都島区,100735,48872,51863,47297,2007-01-01
3317,福島区,61667,29217,32450,30284,2007-01-01
3318,此花区,64331,31238,33093,28303,2007-01-01
3319,西淀川区,96370,47669,48701,41575,2007-01-01
3320,西区,75269,35661,39608,43088,2007-01-01
3321,港区,83762,40978,42784,38619,2007-01-01
3322,大正区,72466,35659,36807,30979,2007-01-01
3323,天王寺区,64826,30094,34732,31487,2007-01-01
3324,中央区,69586,32268,37318,42583,2007-01-01
3325,生野区,136793,65363,71430,61706,2007-02-01
3326,旭区,94556,45194,49362,43701,2007-02-01
3327,城東区,161742,77307,84435,72551,2007-02-01
3328,鶴見区,107839,52053,55786,43112,2007-02-01
3329,阿倍野区,107108,49630,57478,48053,2007-02-01
3330,住吉区,158120,74343,83777,73127,2007-02-01
3331,東住吉区,134033,63514,70519,60396,2007-02-01
3332,平野区,200545,95612,104933,84624,2007-02-01
3333,西成区,129261,75255,54006,77512,2007-02-01
3334,東成区,79304,37760,41544,36965,2007-02-01
3335,住之江区,129748,62301,67447,55516,2007-02-01
3336,東淀川区,177251,88129,89122,90046,2007-02-01
3337,淀川区,170030,84023,86007,86624,2007-02-01
3338,西淀川区,96395,47676,48719,41605,2007-02-01
3339,北区,103161,49530,53631,57723,2007-02-01
3340,都島区,100736,48890,51846,47330,2007-02-01
3341,福島区,61774,29272,32502,30329,2007-02-01
3342,此花区,64313,31226,33087,28310,2007-02-01
3343,中央区,69662,32305,37357,42641,2007-02-01
3344,大阪市,2635507,1280676,1354831,1262342,2007-02-01
3345,港区,83857,41014,42843,38667,2007-02-01
3346,大正区,72368,35621,36747,30959,2007-02-01
3347,天王寺区,64869,30108,34761,31479,2007-02-01
3348,浪速区,56713,28885,27828,36318,2007-02-01
3349,西区,75329,35665,39664,43048,2007-02-01
3350,東成区,79276,37737,41539,36961,2007-03-01
3351,生野区,136752,65345,71407,61781,2007-03-01
3352,旭区,94491,45160,49331,43679,2007-03-01
3353,城東区,161848,77366,84482,72662,2007-03-01
3354,鶴見区,107697,51989,55708,43057,2007-03-01
3355,住之江区,129652,62246,67406,55541,2007-03-01
3356,住吉区,157996,74320,83676,73113,2007-03-01
3357,東住吉区,133971,63498,70473,60437,2007-03-01
3358,平野区,200531,95612,104919,84673,2007-03-01
3359,東淀川区,177151,88105,89046,90051,2007-03-01
3360,阿倍野区,107069,49632,57437,48043,2007-03-01
3361,淀川区,170024,84013,86011,86668,2007-03-01
3362,西成区,128893,74974,53919,77366,2007-03-01
3363,浪速区,56758,28916,27842,36416,2007-03-01
3364,大阪市,2635379,1280487,1354892,1262936,2007-03-01
3365,北区,103251,49575,53676,57817,2007-03-01
3366,都島区,100769,48884,51885,47376,2007-03-01
3367,福島区,61849,29300,32549,30371,2007-03-01
3368,此花区,64272,31214,33058,28290,2007-03-01
3369,西淀川区,96426,47658,48768,41639,2007-03-01
3370,西区,75611,35782,39829,43175,2007-03-01
3371,港区,83880,41043,42837,38684,2007-03-01
3372,大正区,72329,35605,36724,30972,2007-03-01
3373,天王寺区,65076,30159,34917,31483,2007-03-01
3374,中央区,69807,32354,37453,42681,2007-03-01
3375,東成区,79299,37768,41531,37060,2007-04-01
3376,生野区,136701,65331,71370,61895,2007-04-01
3377,旭区,94262,44990,49272,43654,2007-04-01
3378,城東区,162274,77503,84771,73036,2007-04-01
3379,鶴見区,107877,52081,55796,43228,2007-04-01
3380,住之江区,129303,62077,67226,55529,2007-04-01
3381,住吉区,157764,74168,83596,73132,2007-04-01
3382,東住吉区,133813,63414,70399,60523,2007-04-01
3383,平野区,200189,95373,104816,84703,2007-04-01
3384,東淀川区,177112,87989,89123,90367,2007-04-01
3385,阿倍野区,106994,49587,57407,48085,2007-04-01
3386,淀川区,169902,83907,85995,86933,2007-04-01
3387,西成区,128669,73785,54884,75276,2007-04-01
3388,浪速区,56923,28947,27976,36700,2007-04-01
3389,大阪市,2636402,1279166,1357236,1264854,2007-04-01
3390,北区,103408,49574,53834,58137,2007-04-01
3391,都島区,101779,49347,52432,48017,2007-04-01
3392,福島区,62018,29344,32674,30618,2007-04-01
3393,此花区,64138,31137,33001,28311,2007-04-01
3394,西淀川区,96419,47639,48780,41739,2007-04-01
3395,西区,76024,35967,40057,43488,2007-04-01
3396,港区,83920,41039,42881,38807,2007-04-01
3397,大正区,72147,35501,36646,30972,2007-04-01
3398,天王寺区,65138,30171,34967,31585,2007-04-01
3399,中央区,70329,32527,37802,43059,2007-04-01
3400,東成区,79393,37846,41547,37183,2007-05-01
3401,生野区,136850,65384,71466,62001,2007-05-01
3402,旭区,94305,44998,49307,43746,2007-05-01
3403,城東区,162408,77598,84810,73206,2007-05-01
3404,鶴見区,108266,52262,56004,43451,2007-05-01
3405,住之江区,129321,62071,67250,55632,2007-05-01
3406,住吉区,157989,74317,83672,73361,2007-05-01
3407,東住吉区,133905,63458,70447,60630,2007-05-01
3408,平野区,200296,95435,104861,84828,2007-05-01
3409,東淀川区,177452,88182,89270,90731,2007-05-01
3410,阿倍野区,107200,49682,57518,48300,2007-05-01
3411,西成区,128666,73833,54833,75476,2007-05-01
3412,淀川区,170252,84094,86158,87271,2007-05-01
3413,浪速区,57244,29093,28151,36972,2007-05-01
3414,西淀川区,96454,47655,48799,41859,2007-05-01
3415,大阪市,2641139,1281588,1359551,1269492,2007-05-01
3416,北区,103843,49791,54052,58512,2007-05-01
3417,福島区,62221,29448,32773,30812,2007-05-01
3418,此花区,64170,31158,33012,28356,2007-05-01
3419,都島区,102084,49511,52573,48238,2007-05-01
3420,西区,76450,36148,40302,43807,2007-05-01
3421,港区,84029,41090,42939,38936,2007-05-01
3422,大正区,72162,35508,36654,31006,2007-05-01
3423,天王寺区,65393,30271,35122,31766,2007-05-01
3424,中央区,70786,32755,38031,43412,2007-05-01
3425,鶴見区,108411,52308,56103,43532,2007-06-01
3426,生野区,136713,65304,71409,62046,2007-06-01
3427,旭区,94352,45012,49340,43794,2007-06-01
3428,城東区,162423,77607,84816,73252,2007-06-01
3429,阿倍野区,107445,49743,57702,48414,2007-06-01
3430,東成区,79427,37850,41577,37214,2007-06-01
3431,住吉区,158019,74321,83698,73401,2007-06-01
3432,東住吉区,133790,63354,70436,60564,2007-06-01
3433,平野区,200266,95430,104836,84886,2007-06-01
3434,西成区,128461,73726,54735,75479,2007-06-01
3435,住之江区,129337,62078,67259,55709,2007-06-01
3436,東淀川区,177611,88228,89383,90895,2007-06-01
3437,淀川区,170272,84133,86139,87353,2007-06-01
3438,西淀川区,96501,47684,48817,41933,2007-06-01
3439,北区,103969,49868,54101,58697,2007-06-01
3440,都島区,102093,49515,52578,48325,2007-06-01
3441,福島区,62359,29541,32818,30950,2007-06-01
3442,此花区,64150,31153,32997,28367,2007-06-01
3443,中央区,70967,32858,38109,43602,2007-06-01
3444,大阪市,2641895,1281878,1360017,1271405,2007-06-01
3445,港区,84031,41094,42937,39018,2007-06-01
3446,大正区,72141,35502,36639,31031,2007-06-01
3447,天王寺区,65224,30195,35029,31751,2007-06-01
3448,浪速区,57278,29130,28148,37201,2007-06-01
3449,西区,76655,36244,40411,43991,2007-06-01
3450,生野区,136562,65240,71322,62043,2007-07-01
3451,旭区,94350,45030,49320,43816,2007-07-01
3452,城東区,162570,77682,84888,73325,2007-07-01
3453,鶴見区,108499,52325,56174,43579,2007-07-01
3454,阿倍野区,107493,49750,57743,48461,2007-07-01
3455,住吉区,157961,74267,83694,73382,2007-07-01
3456,東住吉区,133636,63288,70348,60550,2007-07-01
3457,平野区,200260,95419,104841,84963,2007-07-01
3458,西成区,128316,73612,54704,75425,2007-07-01
3459,東成区,79353,37800,41553,37233,2007-07-01
3460,住之江区,129252,62029,67223,55721,2007-07-01
3461,東淀川区,177734,88281,89453,91022,2007-07-01
3462,淀川区,170224,84115,86109,87415,2007-07-01
3463,西淀川区,96581,47740,48841,41984,2007-07-01
3464,北区,103921,49838,54083,58699,2007-07-01
3465,都島区,102084,49490,52594,48349,2007-07-01
3466,福島区,62449,29584,32865,31021,2007-07-01
3467,此花区,64153,31166,32987,28385,2007-07-01
3468,中央区,71059,32918,38141,43684,2007-07-01
3469,大阪市,2642015,1281801,1360214,1272266,2007-07-01
3470,港区,84014,41084,42930,39045,2007-07-01
3471,大正区,72110,35462,36648,31005,2007-07-01
3472,天王寺区,65214,30166,35048,31748,2007-07-01
3473,浪速区,57350,29173,28177,37313,2007-07-01
3474,西区,76870,36342,40528,44098,2007-07-01
3475,生野区,136523,65242,71281,62049,2007-08-01
3476,旭区,94277,44986,49291,43813,2007-08-01
3477,城東区,162664,77783,84881,73383,2007-08-01
3478,鶴見区,108703,52432,56271,43670,2007-08-01
3479,阿倍野区,107511,49737,57774,48496,2007-08-01
3480,住吉区,157851,74195,83656,73366,2007-08-01
3481,東住吉区,133624,63271,70353,60552,2007-08-01
3482,平野区,200264,95406,104858,84971,2007-08-01
3483,西成区,128124,73457,54667,75312,2007-08-01
3484,東成区,79386,37826,41560,37256,2007-08-01
3485,住之江区,129167,62006,67161,55744,2007-08-01
3486,東淀川区,177734,88222,89512,90956,2007-08-01
3487,淀川区,170154,84067,86087,87429,2007-08-01
3488,西淀川区,96605,47750,48855,42022,2007-08-01
3489,北区,104026,49832,54194,58676,2007-08-01
3490,都島区,102155,49493,52662,48425,2007-08-01
3491,福島区,62563,29632,32931,31112,2007-08-01
3492,此花区,64178,31194,32984,28419,2007-08-01
3493,中央区,71147,32977,38170,43735,2007-08-01
3494,大阪市,2642330,1281742,1360588,1272790,2007-08-01
3495,港区,84070,41094,42976,39110,2007-08-01
3496,大正区,72010,35396,36614,30970,2007-08-01
3497,天王寺区,65240,30175,35065,31774,2007-08-01
3498,浪速区,57431,29197,28234,37443,2007-08-01
3499,西区,76923,36372,40551,44107,2007-08-01
3500,生野区,136356,65186,71170,62056,2007-09-01
3501,旭区,94206,44949,49257,43827,2007-09-01
3502,城東区,162838,77919,84919,73523,2007-09-01
3503,鶴見区,108762,52453,56309,43691,2007-09-01
3504,阿倍野区,107456,49708,57748,48514,2007-09-01
3505,住吉区,157812,74194,83618,73357,2007-09-01
3506,東住吉区,133549,63248,70301,60545,2007-09-01
3507,平野区,200363,95438,104925,85030,2007-09-01
3508,西成区,127973,73345,54628,75220,2007-09-01
3509,東成区,79381,37822,41559,37294,2007-09-01
3510,住之江区,129226,62004,67222,55825,2007-09-01
3511,東淀川区,177675,88164,89511,91008,2007-09-01
3512,淀川区,170180,84104,86076,87458,2007-09-01
3513,西淀川区,96578,47723,48855,42034,2007-09-01
3514,北区,104184,49893,54291,58772,2007-09-01
3515,都島区,102084,49432,52652,48465,2007-09-01
3516,福島区,62562,29660,32902,31130,2007-09-01
3517,此花区,64199,31214,32985,28458,2007-09-01
3518,中央区,71258,33067,38191,43842,2007-09-01
3519,大阪市,2642454,1281856,1360598,1273660,2007-09-01
3520,港区,84018,41076,42942,39129,2007-09-01
3521,大正区,71950,35393,36557,30955,2007-09-01
3522,天王寺区,65422,30267,35155,31857,2007-09-01
3523,浪速区,57402,29177,28225,37526,2007-09-01
3524,西区,77020,36420,40600,44144,2007-09-01
3525,生野区,136276,65148,71128,62061,2007-10-01
3526,旭区,94136,44981,49155,43791,2007-10-01
3527,城東区,162893,77956,84937,73560,2007-10-01
3528,鶴見区,108931,52549,56382,43790,2007-10-01
3529,阿倍野区,107402,49700,57702,48516,2007-10-01
3530,住吉区,157760,74191,83569,73368,2007-10-01
3531,東住吉区,133388,63202,70186,60507,2007-10-01
3532,平野区,200439,95554,104885,85053,2007-10-01
3533,西成区,127791,74796,52995,74677,2007-10-01
3534,東成区,79354,37806,41548,37261,2007-10-01
3535,住之江区,129279,62109,67170,55892,2007-10-01
3536,東淀川区,177583,88175,89408,90919,2007-10-01
3537,淀川区,170078,84097,85981,87421,2007-10-01
3538,西淀川区,96624,47773,48851,42077,2007-10-01
3539,北区,104229,50068,54161,58880,2007-10-01
3540,都島区,102046,49440,52606,48442,2007-10-01
3541,福島区,62537,29663,32874,31102,2007-10-01
3542,此花区,64460,31358,33102,28574,2007-10-01
3543,中央区,71378,33290,38088,43917,2007-10-01
3544,大阪市,2642854,1284596,1358258,1273724,2007-10-01
3545,港区,84043,41107,42936,39191,2007-10-01
3546,大正区,71874,35404,36470,30925,2007-10-01
3547,天王寺区,65708,30445,35263,31998,2007-10-01
3548,浪速区,57543,29323,28220,37664,2007-10-01
3549,西区,77102,36461,40641,44138,2007-10-01
3550,生野区,136206,65124,71082,62086,2007-11-01
3551,旭区,94182,45020,49162,43839,2007-11-01
3552,城東区,162935,77998,84937,73567,2007-11-01
3553,鶴見区,109066,52605,56461,43835,2007-11-01
3554,阿倍野区,107416,49688,57728,48518,2007-11-01
3555,住吉区,157712,74169,83543,73352,2007-11-01
3556,東住吉区,133455,63230,70225,60570,2007-11-01
3557,平野区,200565,95604,104961,85134,2007-11-01
3558,西成区,127718,74793,52925,74488,2007-11-01
3559,東成区,79410,37855,41555,37313,2007-11-01
3560,住之江区,129239,62079,67160,55926,2007-11-01
3561,東淀川区,177654,88218,89436,90986,2007-11-01
3562,淀川区,170014,84071,85943,87417,2007-11-01
3563,西淀川区,96681,47806,48875,42086,2007-11-01
3564,北区,104400,50165,54235,58941,2007-11-01
3565,都島区,102032,49432,52600,48421,2007-11-01
3566,福島区,62636,29679,32957,31151,2007-11-01
3567,此花区,64612,31443,33169,28660,2007-11-01
3568,中央区,71528,33350,38178,43972,2007-11-01
3569,大阪市,2644418,1285362,1359056,1274419,2007-11-01
3570,港区,84142,41176,42966,39184,2007-11-01
3571,大正区,71778,35361,36417,30930,2007-11-01
3572,天王寺区,65897,30519,35378,32078,2007-11-01
3573,浪速区,57835,29434,28401,37737,2007-11-01
3574,西区,77305,36543,40762,44228,2007-11-01
3575,生野区,136042,65075,70967,62049,2007-12-01
3576,旭区,94183,45039,49144,43854,2007-12-01
3577,城東区,163068,78034,85034,73647,2007-12-01
3578,鶴見区,109503,52818,56685,44037,2007-12-01
3579,阿倍野区,107360,49665,57695,48512,2007-12-01
3580,住吉区,157528,74052,83476,73296,2007-12-01
3581,東住吉区,133410,63208,70202,60559,2007-12-01
3582,平野区,200628,95638,104990,85211,2007-12-01
3583,西成区,127633,74772,52861,74587,2007-12-01
3584,東成区,79399,37844,41555,37344,2007-12-01
3585,住之江区,129127,62013,67114,55889,2007-12-01
3586,東淀川区,177513,88152,89361,90923,2007-12-01
3587,淀川区,170053,84081,85972,87427,2007-12-01
3588,西淀川区,96661,47788,48873,42077,2007-12-01
3589,北区,104470,50194,54276,59044,2007-12-01
3590,都島区,101967,49395,52572,48420,2007-12-01
3591,福島区,62871,29782,33089,31265,2007-12-01
3592,此花区,64531,31363,33168,28621,2007-12-01
3593,中央区,71604,33363,38241,44032,2007-12-01
3594,大阪市,2644759,1285431,1359328,1275189,2007-12-01
3595,港区,84175,41227,42948,39241,2007-12-01
3596,大正区,71692,35313,36379,30913,2007-12-01
3597,天王寺区,65971,30544,35427,32120,2007-12-01
3598,浪速区,57923,29459,28464,37829,2007-12-01
3599,西区,77447,36612,40835,44292,2007-12-01
3600,生野区,135928,65028,70900,62038,2008-01-01
3601,旭区,94148,45013,49135,43869,2008-01-01
3602,城東区,163049,78003,85046,73641,2008-01-01
3603,鶴見区,109657,52888,56769,44065,2008-01-01
3604,阿倍野区,107269,49616,57653,48492,2008-01-01
3605,住吉区,157414,74000,83414,73245,2008-01-01
3606,東住吉区,133396,63185,70211,60539,2008-01-01
3607,平野区,200607,95627,104980,85202,2008-01-01
3608,西成区,127463,74685,52778,74458,2008-01-01
3609,東成区,79363,37831,41532,37358,2008-01-01
3610,住之江区,128973,61909,67064,55874,2008-01-01
3611,東淀川区,177474,88093,89381,90892,2008-01-01
3612,淀川区,169969,84065,85904,87458,2008-01-01
3613,西淀川区,96653,47795,48858,42071,2008-01-01
3614,北区,104485,50175,54310,59096,2008-01-01
3615,都島区,101893,49334,52559,48410,2008-01-01
3616,福島区,62988,29834,33154,31334,2008-01-01
3617,此花区,64519,31366,33153,28603,2008-01-01
3618,中央区,71646,33384,38262,44106,2008-01-01
3619,大阪市,2644233,1285054,1359179,1275346,2008-01-01
3620,港区,84200,41263,42937,39278,2008-01-01
3621,大正区,71630,35278,36352,30907,2008-01-01
3622,天王寺区,66022,30569,35453,32171,2008-01-01
3623,浪速区,57934,29460,28474,37873,2008-01-01
3624,西区,77553,36653,40900,44366,2008-01-01
3625,東成区,79281,37803,41478,37332,2008-02-01
3626,生野区,135871,64998,70873,62033,2008-02-01
3627,旭区,94052,44949,49103,43849,2008-02-01
3628,城東区,162975,77966,85009,73601,2008-02-01
3629,鶴見区,109674,52890,56784,44065,2008-02-01
3630,住之江区,128812,61833,66979,55839,2008-02-01
3631,住吉区,157334,73984,83350,73211,2008-02-01
3632,東住吉区,133336,63181,70155,60544,2008-02-01
3633,平野区,200508,95524,104984,85174,2008-02-01
3634,東淀川区,177473,88065,89408,90912,2008-02-01
3635,阿倍野区,107241,49643,57598,48526,2008-02-01
3636,淀川区,169968,84023,85945,87444,2008-02-01
3637,西成区,127323,74586,52737,74353,2008-02-01
3638,浪速区,57977,29497,28480,37977,2008-02-01
3639,大阪市,2643573,1284589,1358984,1275365,2008-02-01
3640,北区,104564,50188,54376,59215,2008-02-01
3641,都島区,101915,49335,52580,48427,2008-02-01
3642,福島区,63002,29846,33156,31345,2008-02-01
3643,此花区,64469,31336,33133,28580,2008-02-01
3644,西淀川区,96682,47804,48878,42109,2008-02-01
3645,西区,77604,36638,40966,44323,2008-02-01
3646,港区,84190,41258,42932,39300,2008-02-01
3647,大正区,71545,35243,36302,30879,2008-02-01
3648,天王寺区,66023,30549,35474,32177,2008-02-01
3649,中央区,71754,33450,38304,44150,2008-02-01
3650,生野区,135772,64938,70834,62041,2008-03-01
3651,旭区,93987,44923,49064,43834,2008-03-01
3652,城東区,163601,78293,85308,73917,2008-03-01
3653,鶴見区,109605,52838,56767,44064,2008-03-01
3654,阿倍野区,107129,49600,57529,48464,2008-03-01
3655,住吉区,157174,73905,83269,73176,2008-03-01
3656,東住吉区,133251,63150,70101,60490,2008-03-01
3657,平野区,200393,95460,104933,85189,2008-03-01
3658,西成区,127154,74533,52621,74233,2008-03-01
3659,東成区,79213,37769,41444,37307,2008-03-01
3660,住之江区,128643,61768,66875,55794,2008-03-01
3661,東淀川区,177277,87949,89328,90867,2008-03-01
3662,淀川区,169795,83895,85900,87386,2008-03-01
3663,西淀川区,96716,47816,48900,42105,2008-03-01
3664,北区,104622,50208,54414,59307,2008-03-01
3665,都島区,101881,49320,52561,48438,2008-03-01
3666,福島区,63118,29904,33214,31407,2008-03-01
3667,此花区,64444,31333,33111,28556,2008-03-01
3668,中央区,71818,33511,38307,44170,2008-03-01
3669,大阪市,2643151,1284386,1358765,1275646,2008-03-01
3670,港区,84261,41292,42969,39347,2008-03-01
3671,大正区,71513,35215,36298,30884,2008-03-01
3672,天王寺区,66030,30553,35477,32188,2008-03-01
3673,浪速区,58100,29540,28560,38147,2008-03-01
3674,西区,77654,36673,40981,44335,2008-03-01
3675,生野区,135655,64849,70806,62077,2008-04-01
3676,旭区,93831,44839,48992,43832,2008-04-01
3677,城東区,164189,78571,85618,74433,2008-04-01
3678,鶴見区,109466,52751,56715,44149,2008-04-01
3679,阿倍野区,107145,49557,57588,48587,2008-04-01
3680,住吉区,156865,73726,83139,73230,2008-04-01
3681,東住吉区,133178,63116,70062,60574,2008-04-01
3682,平野区,200097,95276,104821,85272,2008-04-01
3683,西成区,126993,74451,52542,74260,2008-04-01
3684,東成区,79261,37775,41486,37436,2008-04-01
3685,住之江区,128295,61609,66686,55740,2008-04-01
3686,東淀川区,177313,87860,89453,91185,2008-04-01
3687,淀川区,169963,83968,85995,87911,2008-04-01
3688,西淀川区,96675,47801,48874,42199,2008-04-01
3689,北区,104838,50270,54568,59756,2008-04-01
3690,都島区,101761,49237,52524,48537,2008-04-01
3691,福島区,63431,29997,33434,31621,2008-04-01
3692,此花区,64632,31440,33192,28714,2008-04-01
3693,中央区,72025,33578,38447,44433,2008-04-01
3694,大阪市,2643771,1284136,1359635,1279876,2008-04-01
3695,港区,84273,41287,42986,39535,2008-04-01
3696,大正区,71367,35151,36216,30819,2008-04-01
3697,天王寺区,66305,30613,35692,32460,2008-04-01
3698,浪速区,58148,29556,28592,38336,2008-04-01
3699,西区,78065,36858,41207,44780,2008-04-01
3700,生野区,135682,64864,70818,62195,2008-05-01
3701,旭区,93770,44820,48950,43872,2008-05-01
3702,城東区,164751,78825,85926,74824,2008-05-01
3703,鶴見区,109658,52819,56839,44300,2008-05-01
3704,阿倍野区,107343,49642,57701,48819,2008-05-01
3705,住吉区,157130,73875,83255,73422,2008-05-01
3706,東住吉区,133199,63129,70070,60686,2008-05-01
3707,平野区,200421,95460,104961,85511,2008-05-01
3708,西成区,126991,74441,52550,74363,2008-05-01
3709,東成区,79348,37838,41510,37584,2008-05-01
3710,住之江区,128201,61551,66650,55792,2008-05-01
3711,東淀川区,177531,87960,89571,91475,2008-05-01
3712,淀川区,170357,84181,86176,88330,2008-05-01
3713,西淀川区,96718,47859,48859,42306,2008-05-01
3714,北区,105263,50470,54793,60116,2008-05-01
3715,都島区,101863,49275,52588,48681,2008-05-01
3716,福島区,63623,30087,33536,31767,2008-05-01
3717,此花区,64765,31511,33254,28791,2008-05-01
3718,中央区,72568,33827,38741,44771,2008-05-01
3719,大阪市,2648370,1286407,1361963,1284417,2008-05-01
3720,港区,84441,41385,43056,39695,2008-05-01
3721,大正区,71380,35153,36227,30855,2008-05-01
3722,天王寺区,66568,30746,35822,32661,2008-05-01
3723,浪速区,58348,29643,28705,38527,2008-05-01
3724,西区,78451,37046,41405,45074,2008-05-01
3725,東成区,79387,37866,41521,37650,2008-06-01
3726,生野区,135575,64851,70724,62210,2008-06-01
3727,旭区,93798,44837,48961,43916,2008-06-01
3728,城東区,164922,78943,85979,74947,2008-06-01
3729,鶴見区,109778,52867,56911,44364,2008-06-01
3730,住之江区,128118,61499,66619,55774,2008-06-01
3731,住吉区,156993,73811,83182,73398,2008-06-01
3732,東住吉区,133081,63065,70016,60662,2008-06-01
3733,平野区,200400,95436,104964,85561,2008-06-01
3734,東淀川区,177506,87962,89544,91525,2008-06-01
3735,阿倍野区,107322,49623,57699,48847,2008-06-01
3736,淀川区,170501,84252,86249,88491,2008-06-01
3737,西成区,126788,74360,52428,74378,2008-06-01
3738,浪速区,58441,29719,28722,38654,2008-06-01
3739,大阪市,2649151,1286993,1362158,1285946,2008-06-01
3740,北区,105435,50560,54875,60301,2008-06-01
3741,都島区,101890,49311,52579,48747,2008-06-01
3742,福島区,63750,30175,33575,31888,2008-06-01
3743,此花区,64727,31488,33239,28769,2008-06-01
3744,西淀川区,96787,47905,48882,42377,2008-06-01
3745,西区,78672,37170,41502,45202,2008-06-01
3746,港区,84552,41450,43102,39801,2008-06-01
3747,大正区,71380,35157,36223,30862,2008-06-01
3748,天王寺区,66672,30802,35870,32754,2008-06-01
3749,中央区,72676,33884,38792,44868,2008-06-01
3750,生野区,135449,64777,70672,62233,2008-07-01
3751,旭区,93742,44805,48937,43898,2008-07-01
3752,城東区,165034,78983,86051,75034,2008-07-01
3753,鶴見区,109928,52958,56970,44421,2008-07-01
3754,阿倍野区,107261,49587,57674,48851,2008-07-01
3755,住吉区,156939,73792,83147,73411,2008-07-01
3756,東住吉区,133015,63014,70001,60604,2008-07-01
3757,平野区,200397,95427,104970,85634,2008-07-01
3758,西成区,126631,74275,52356,74446,2008-07-01
3759,東成区,79400,37894,41506,37669,2008-07-01
3760,住之江区,128044,61444,66600,55781,2008-07-01
3761,東淀川区,177571,87965,89606,91589,2008-07-01
3762,淀川区,170627,84292,86335,88623,2008-07-01
3763,西淀川区,96833,47960,48873,42448,2008-07-01
3764,北区,105547,50575,54972,60438,2008-07-01
3765,都島区,101829,49277,52552,48754,2008-07-01
3766,福島区,63890,30242,33648,31991,2008-07-01
3767,此花区,64699,31473,33226,28755,2008-07-01
3768,中央区,72780,33919,38861,44996,2008-07-01
3769,大阪市,2649604,1287078,1362526,1287149,2008-07-01
3770,港区,84544,41432,43112,39818,2008-07-01
3771,大正区,71322,35133,36189,30851,2008-07-01
3772,天王寺区,66776,30858,35918,32820,2008-07-01
3773,浪速区,58441,29720,28721,38756,2008-07-01
3774,西区,78905,37276,41629,45328,2008-07-01
3775,東成区,79413,37899,41514,37710,2008-08-01
3776,生野区,135390,64740,70650,62219,2008-08-01
3777,旭区,93655,44752,48903,43886,2008-08-01
3778,城東区,165035,78977,86058,75070,2008-08-01
3779,鶴見区,109921,52949,56972,44431,2008-08-01
3780,住之江区,128018,61455,66563,55826,2008-08-01
3781,住吉区,156916,73828,83088,73364,2008-08-01
3782,東住吉区,132910,62950,69960,60590,2008-08-01
3783,平野区,200341,95410,104931,85687,2008-08-01
3784,東淀川区,177476,87903,89573,91612,2008-08-01
3785,阿倍野区,107264,49561,57703,48876,2008-08-01
3786,淀川区,170669,84325,86344,88737,2008-08-01
3787,西成区,126361,74119,52242,74436,2008-08-01
3788,浪速区,58629,29813,28816,38941,2008-08-01
3789,大阪市,2649783,1287137,1362646,1288185,2008-08-01
3790,北区,105750,50682,55068,60648,2008-08-01
3791,都島区,101826,49289,52537,48806,2008-08-01
3792,福島区,64032,30304,33728,32049,2008-08-01
3793,此花区,64684,31464,33220,28775,2008-08-01
3794,西淀川区,96834,47965,48869,42468,2008-08-01
3795,西区,79175,37422,41753,45453,2008-08-01
3796,港区,84571,41462,43109,39865,2008-08-01
3797,大正区,71210,35049,36161,30833,2008-08-01
3798,天王寺区,66780,30859,35921,32837,2008-08-01
3799,中央区,72923,33960,38963,45066,2008-08-01
3800,東成区,79432,37940,41492,37738,2008-09-01
3801,生野区,135254,64671,70583,62229,2008-09-01
3802,旭区,93620,44739,48881,43914,2008-09-01
3803,城東区,165063,78995,86068,75096,2008-09-01
3804,鶴見区,109943,52938,57005,44434,2008-09-01
3805,住之江区,127893,61385,66508,55791,2008-09-01
3806,住吉区,156940,73839,83101,73405,2008-09-01
3807,東住吉区,132873,62917,69956,60599,2008-09-01
3808,平野区,200316,95389,104927,85678,2008-09-01
3809,東淀川区,177371,87825,89546,91577,2008-09-01
3810,阿倍野区,107167,49495,57672,48807,2008-09-01
3811,淀川区,170737,84374,86363,88875,2008-09-01
3812,西成区,126185,74010,52175,74440,2008-09-01
3813,浪速区,58757,29867,28890,39053,2008-09-01
3814,大阪市,2650368,1287334,1363034,1289261,2008-09-01
3815,北区,105947,50794,55153,60841,2008-09-01
3816,都島区,101760,49281,52479,48821,2008-09-01
3817,福島区,64370,30451,33919,32226,2008-09-01
3818,此花区,64741,31511,33230,28820,2008-09-01
3819,西淀川区,96816,47940,48876,42488,2008-09-01
3820,西区,79296,37471,41825,45498,2008-09-01
3821,港区,84631,41476,43155,39922,2008-09-01
3822,大正区,71150,35001,36149,30838,2008-09-01
3823,天王寺区,66914,30913,36001,32917,2008-09-01
3824,中央区,73192,34112,39080,45254,2008-09-01
3825,東成区,79453,37961,41492,37747,2008-10-01
3826,生野区,135256,64686,70570,62238,2008-10-01
3827,旭区,93525,44679,48846,43863,2008-10-01
3828,城東区,165016,78976,86040,75098,2008-10-01
3829,鶴見区,110037,52973,57064,44454,2008-10-01
3830,住之江区,127789,61355,66434,55768,2008-10-01
3831,住吉区,156880,73782,83098,73415,2008-10-01
3832,東住吉区,132830,62912,69918,60535,2008-10-01
3833,平野区,200304,95377,104927,85721,2008-10-01
3834,東淀川区,177501,87848,89653,91665,2008-10-01
3835,阿倍野区,107101,49456,57645,48794,2008-10-01
3836,西成区,125950,73866,52084,74383,2008-10-01
3837,淀川区,170740,84394,86346,88896,2008-10-01
3838,浪速区,58822,29889,28933,39079,2008-10-01
3839,西淀川区,96858,47962,48896,42526,2008-10-01
3840,大阪市,2650670,1287428,1363242,1289751,2008-10-01
3841,北区,106077,50896,55181,60965,2008-10-01
3842,福島区,64513,30534,33979,32304,2008-10-01
3843,此花区,64764,31522,33242,28786,2008-10-01
3844,都島区,101770,49261,52509,48843,2008-10-01
3845,西区,79413,37514,41899,45548,2008-10-01
3846,港区,84652,41485,43167,39956,2008-10-01
3847,大正区,71098,34959,36139,30843,2008-10-01
3848,天王寺区,67057,31000,36057,33009,2008-10-01
3849,中央区,73264,34141,39123,45315,2008-10-01
3850,鶴見区,110146,53011,57135,44490,2008-11-01
3851,生野区,135246,64697,70549,62272,2008-11-01
3852,旭区,93449,44639,48810,43839,2008-11-01
3853,城東区,165062,79027,86035,75110,2008-11-01
3854,阿倍野区,107129,49463,57666,48854,2008-11-01
3855,東成区,79430,37958,41472,37736,2008-11-01
3856,住吉区,156781,73716,83065,73390,2008-11-01
3857,東住吉区,132828,62902,69926,60506,2008-11-01
3858,平野区,200272,95369,104903,85742,2008-11-01
3859,西成区,125847,73813,52034,74427,2008-11-01
3860,住之江区,127723,61296,66427,55769,2008-11-01
3861,東淀川区,177604,87894,89710,91692,2008-11-01
3862,淀川区,170660,84389,86271,88909,2008-11-01
3863,西淀川区,96929,48016,48913,42583,2008-11-01
3864,北区,106295,51020,55275,61164,2008-11-01
3865,都島区,101766,49246,52520,48877,2008-11-01
3866,福島区,64642,30604,34038,32371,2008-11-01
3867,此花区,64835,31543,33292,28841,2008-11-01
3868,中央区,73424,34187,39237,45397,2008-11-01
3869,大阪市,2651878,1288003,1363875,1290807,2008-11-01
3870,港区,84692,41510,43182,39990,2008-11-01
3871,大正区,71126,34949,36177,30858,2008-11-01
3872,天王寺区,67305,31131,36174,33125,2008-11-01
3873,浪速区,59074,29989,29085,39237,2008-11-01
3874,西区,79613,37634,41979,45628,2008-11-01
3875,生野区,135209,64683,70526,62264,2008-12-01
3876,旭区,93437,44636,48801,43828,2008-12-01
3877,城東区,165064,79018,86046,75119,2008-12-01
3878,鶴見区,110274,53055,57219,44519,2008-12-01
3879,阿倍野区,107054,49420,57634,48841,2008-12-01
3880,住吉区,156764,73712,83052,73410,2008-12-01
3881,東住吉区,132723,62854,69869,60496,2008-12-01
3882,平野区,200347,95419,104928,85761,2008-12-01
3883,西成区,125751,73787,51964,74492,2008-12-01
3884,東成区,79369,37926,41443,37741,2008-12-01
3885,住之江区,127726,61265,66461,55773,2008-12-01
3886,東淀川区,177554,87839,89715,91595,2008-12-01
3887,淀川区,170649,84379,86270,88958,2008-12-01
3888,西淀川区,96985,48063,48922,42634,2008-12-01
3889,北区,106382,51077,55305,61265,2008-12-01
3890,都島区,101721,49215,52506,48877,2008-12-01
3891,福島区,64721,30639,34082,32429,2008-12-01
3892,此花区,64855,31574,33281,28880,2008-12-01
3893,中央区,73474,34210,39264,45461,2008-12-01
3894,大阪市,2652110,1288113,1363997,1291387,2008-12-01
3895,港区,84735,41526,43209,39962,2008-12-01
3896,大正区,71085,34931,36154,30845,2008-12-01
3897,天王寺区,67360,31152,36208,33180,2008-12-01
3898,浪速区,59134,30035,29099,39369,2008-12-01
3899,西区,79737,37698,42039,45688,2008-12-01
3900,生野区,135137,64627,70510,62210,2009-01-01
3901,旭区,93404,44622,48782,43834,2009-01-01
3902,城東区,165079,79015,86064,75116,2009-01-01
3903,鶴見区,110485,53164,57321,44627,2009-01-01
3904,阿倍野区,107046,49425,57621,48841,2009-01-01
3905,住吉区,156696,73710,82986,73381,2009-01-01
3906,東住吉区,132634,62819,69815,60432,2009-01-01
3907,平野区,200377,95404,104973,85801,2009-01-01
3908,西成区,125625,73722,51903,74473,2009-01-01
3909,東成区,79412,37939,41473,37770,2009-01-01
3910,住之江区,127712,61266,66446,55804,2009-01-01
3911,東淀川区,177433,87751,89682,91520,2009-01-01
3912,淀川区,170623,84366,86257,88988,2009-01-01
3913,西淀川区,96993,48054,48939,42625,2009-01-01
3914,北区,106502,51083,55419,61346,2009-01-01
3915,都島区,101709,49221,52488,48899,2009-01-01
3916,福島区,64777,30664,34113,32442,2009-01-01
3917,此花区,64869,31564,33305,28879,2009-01-01
3918,中央区,73629,34305,39324,45553,2009-01-01
3919,大阪市,2652436,1288163,1364273,1291734,2009-01-01
3920,港区,84722,41550,43172,39956,2009-01-01
3921,大正区,70985,34873,36112,30800,2009-01-01
3922,天王寺区,67438,31197,36241,33232,2009-01-01
3923,浪速区,59225,30070,29155,39438,2009-01-01
3924,西区,79924,37752,42172,45767,2009-01-01
3925,生野区,135033,64561,70472,62206,2009-02-01
3926,旭区,93340,44598,48742,43787,2009-02-01
3927,城東区,164998,78996,86002,75026,2009-02-01
3928,鶴見区,110642,53234,57408,44682,2009-02-01
3929,阿倍野区,107019,49394,57625,48834,2009-02-01
3930,住吉区,156592,73660,82932,73346,2009-02-01
3931,東住吉区,132491,62780,69711,60360,2009-02-01
3932,平野区,200443,95435,105008,85767,2009-02-01
3933,西成区,125428,73627,51801,74437,2009-02-01
3934,東成区,79321,37906,41415,37742,2009-02-01
3935,住之江区,127688,61282,66406,55805,2009-02-01
3936,東淀川区,177260,87660,89600,91498,2009-02-01
3937,淀川区,170682,84356,86326,88996,2009-02-01
3938,西淀川区,97026,48049,48977,42674,2009-02-01
3939,北区,106592,51144,55448,61412,2009-02-01
3940,都島区,101682,49202,52480,48925,2009-02-01
3941,福島区,64815,30679,34136,32455,2009-02-01
3942,此花区,64834,31550,33284,28857,2009-02-01
3943,中央区,73758,34408,39350,45554,2009-02-01
3944,大阪市,2651966,1287938,1364028,1291683,2009-02-01
3945,港区,84609,41489,43120,39951,2009-02-01
3946,大正区,70912,34856,36056,30785,2009-02-01
3947,天王寺区,67490,31218,36272,33254,2009-02-01
3948,浪速区,59213,30027,29186,39519,2009-02-01
3949,西区,80098,37827,42271,45811,2009-02-01
3950,生野区,134976,64550,70426,62186,2009-03-01
3951,旭区,93262,44587,48675,43781,2009-03-01
3952,城東区,165044,79034,86010,75050,2009-03-01
3953,鶴見区,110718,53266,57452,44721,2009-03-01
3954,阿倍野区,106980,49365,57615,48810,2009-03-01
3955,住吉区,156548,73634,82914,73370,2009-03-01
3956,東住吉区,132341,62688,69653,60310,2009-03-01
3957,平野区,200459,95440,105019,85785,2009-03-01
3958,西成区,125273,73567,51706,74465,2009-03-01
3959,東成区,79334,37922,41412,37772,2009-03-01
3960,住之江区,127635,61244,66391,55845,2009-03-01
3961,東淀川区,177185,87607,89578,91447,2009-03-01
3962,淀川区,170722,84366,86356,89043,2009-03-01
3963,西淀川区,96938,48016,48922,42671,2009-03-01
3964,北区,106606,51131,55475,61483,2009-03-01
3965,都島区,101638,49168,52470,48929,2009-03-01
3966,福島区,64923,30704,34219,32513,2009-03-01
3967,此花区,64808,31527,33281,28862,2009-03-01
3968,中央区,73889,34499,39390,45623,2009-03-01
3969,大阪市,2651781,1287847,1363934,1292153,2009-03-01
3970,港区,84635,41504,43131,39972,2009-03-01
3971,大正区,70875,34842,36033,30803,2009-03-01
3972,天王寺区,67480,31224,36256,33263,2009-03-01
3973,浪速区,59339,30102,29237,39671,2009-03-01
3974,西区,80173,37860,42313,45778,2009-03-01
3975,生野区,134930,64501,70429,62352,2009-04-01
3976,旭区,93118,44535,48583,43772,2009-04-01
3977,城東区,165484,79204,86280,75387,2009-04-01
3978,鶴見区,110585,53161,57424,44788,2009-04-01
3979,阿倍野区,106792,49221,57571,48841,2009-04-01
3980,住吉区,156292,73437,82855,73396,2009-04-01
3981,東住吉区,132188,62586,69602,60310,2009-04-01
3982,平野区,200203,95249,104954,85807,2009-04-01
3983,西成区,125120,73482,51638,74601,2009-04-01
3984,東成区,79468,37939,41529,37884,2009-04-01
3985,住之江区,127532,61150,66382,55941,2009-04-01
3986,東淀川区,177102,87512,89590,91671,2009-04-01
3987,淀川区,170935,84447,86488,89466,2009-04-01
3988,西淀川区,97019,48048,48971,42899,2009-04-01
3989,北区,106856,51191,55665,61883,2009-04-01
3990,都島区,101670,49134,52536,49063,2009-04-01
3991,福島区,65073,30785,34288,32676,2009-04-01
3992,此花区,64713,31474,33239,28833,2009-04-01
3993,中央区,74525,34833,39692,46138,2009-04-01
3994,大阪市,2652906,1287773,1365133,1296066,2009-04-01
3995,港区,84774,41540,43234,40187,2009-04-01
3996,大正区,70735,34793,35942,30796,2009-04-01
3997,天王寺区,67708,31325,36383,33432,2009-04-01
3998,浪速区,59644,30267,29377,39942,2009-04-01
3999,西区,80440,37959,42481,46001,2009-04-01
4000,生野区,135051,64587,70464,62483,2009-05-01
4001,旭区,93110,44564,48546,43846,2009-05-01
4002,城東区,165692,79328,86364,75532,2009-05-01
4003,鶴見区,110720,53209,57511,44872,2009-05-01
4004,阿倍野区,106949,49281,57668,49008,2009-05-01
4005,住吉区,156397,73494,82903,73516,2009-05-01
4006,東住吉区,132149,62538,69611,60335,2009-05-01
4007,平野区,200215,95267,104948,85895,2009-05-01
4008,西成区,125145,73515,51630,74745,2009-05-01
4009,東成区,79579,38008,41571,38017,2009-05-01
4010,住之江区,127647,61266,66381,56066,2009-05-01
4011,東淀川区,177287,87577,89710,91894,2009-05-01
4012,淀川区,171370,84657,86713,89815,2009-05-01
4013,西淀川区,97161,48148,49013,43081,2009-05-01
4014,北区,107235,51398,55837,62267,2009-05-01
4015,都島区,101916,49293,52623,49262,2009-05-01
4016,福島区,65335,30904,34431,32826,2009-05-01
4017,此花区,64693,31466,33227,28836,2009-05-01
4018,中央区,75331,35253,40078,46625,2009-05-01
4019,大阪市,2657309,1290124,1367185,1300054,2009-05-01
4020,港区,84950,41618,43332,40337,2009-05-01
4021,大正区,70697,34781,35916,30791,2009-05-01
4022,天王寺区,68013,31462,36551,33644,2009-05-01
4023,浪速区,59984,30405,29579,40185,2009-05-01
4024,西区,80683,38105,42578,46176,2009-05-01
4025,生野区,135015,64575,70440,62533,2009-06-01
4026,旭区,93120,44582,48538,43872,2009-06-01
4027,城東区,165818,79404,86414,75553,2009-06-01
4028,鶴見区,110745,53208,57537,44916,2009-06-01
4029,阿倍野区,106933,49265,57668,49054,2009-06-01
4030,住吉区,156440,73489,82951,73544,2009-06-01
4031,東住吉区,132078,62559,69519,60304,2009-06-01
4032,平野区,200265,95296,104969,85936,2009-06-01
4033,西成区,125031,73469,51562,74819,2009-06-01
4034,東成区,79503,37958,41545,38048,2009-06-01
4035,住之江区,127615,61250,66365,56074,2009-06-01
4036,東淀川区,177236,87556,89680,91952,2009-06-01
4037,淀川区,171553,84795,86758,89985,2009-06-01
4038,西淀川区,97223,48167,49056,43130,2009-06-01
4039,北区,107440,51490,55950,62465,2009-06-01
4040,都島区,102007,49291,52716,49333,2009-06-01
4041,福島区,65508,31012,34496,32962,2009-06-01
4042,此花区,64712,31478,33234,28872,2009-06-01
4043,中央区,75497,35327,40170,46820,2009-06-01
4044,大阪市,2658415,1290783,1367632,1301616,2009-06-01
4045,港区,84899,41638,43261,40300,2009-06-01
4046,大正区,70662,34762,35900,30795,2009-06-01
4047,天王寺区,68179,31540,36639,33757,2009-06-01
4048,浪速区,60166,30522,29644,40386,2009-06-01
4049,西区,80770,38150,42620,46206,2009-06-01
4050,東成区,79493,37957,41536,38062,2009-07-01
4051,生野区,134917,64549,70368,62575,2009-07-01
4052,旭区,93159,44618,48541,43907,2009-07-01
4053,城東区,165734,79389,86345,75572,2009-07-01
4054,鶴見区,110841,53252,57589,44946,2009-07-01
4055,住之江区,127633,61259,66374,56136,2009-07-01
4056,住吉区,156391,73521,82870,73595,2009-07-01
4057,東住吉区,131998,62530,69468,60293,2009-07-01
4058,平野区,200310,95318,104992,86012,2009-07-01
4059,東淀川区,177225,87549,89676,91944,2009-07-01
4060,阿倍野区,106887,49249,57638,49089,2009-07-01
4061,淀川区,171627,84820,86807,90071,2009-07-01
4062,西成区,124957,73486,51471,74950,2009-07-01
4063,浪速区,60053,30466,29587,40439,2009-07-01
4064,大阪市,2658800,1291192,1367608,1302898,2009-07-01
4065,北区,107574,51547,56027,62610,2009-07-01
4066,都島区,102096,49298,52798,49427,2009-07-01
4067,福島区,65608,31072,34536,33037,2009-07-01
4068,此花区,64664,31439,33225,28857,2009-07-01
4069,西淀川区,97245,48174,49071,43148,2009-07-01
4070,西区,80959,38308,42651,46264,2009-07-01
4071,港区,84869,41642,43227,40320,2009-07-01
4072,大正区,70554,34700,35854,30775,2009-07-01
4073,天王寺区,68276,31570,36706,33801,2009-07-01
4074,中央区,75730,35479,40251,47068,2009-07-01
4075,生野区,134916,64593,70323,62625,2009-08-01
4076,旭区,93082,44609,48473,43898,2009-08-01
4077,城東区,165708,79371,86337,75566,2009-08-01
4078,鶴見区,110877,53265,57612,44979,2009-08-01
4079,阿倍野区,106737,49189,57548,49028,2009-08-01
4080,住吉区,156337,73507,82830,73596,2009-08-01
4081,東住吉区,131904,62485,69419,60295,2009-08-01
4082,平野区,200276,95297,104979,86074,2009-08-01
4083,西成区,124837,73457,51380,74990,2009-08-01
4084,東成区,79510,37965,41545,38118,2009-08-01
4085,住之江区,127601,61243,66358,56152,2009-08-01
4086,東淀川区,177156,87512,89644,91921,2009-08-01
4087,淀川区,171765,84885,86880,90203,2009-08-01
4088,西淀川区,97297,48210,49087,43193,2009-08-01
4089,北区,107630,51584,56046,62731,2009-08-01
4090,都島区,102109,49305,52804,49458,2009-08-01
4091,福島区,65698,31104,34594,33121,2009-08-01
4092,此花区,64776,31509,33267,28926,2009-08-01
4093,中央区,75909,35583,40326,47183,2009-08-01
4094,大阪市,2659120,1291587,1367533,1303921,2009-08-01
4095,港区,84864,41641,43223,40326,2009-08-01
4096,大正区,70515,34686,35829,30774,2009-08-01
4097,天王寺区,68393,31651,36742,33868,2009-08-01
4098,浪速区,60139,30556,29583,40589,2009-08-01
4099,西区,81084,38380,42704,46307,2009-08-01
4100,生野区,134868,64590,70278,62677,2009-09-01
4101,旭区,93067,44590,48477,43897,2009-09-01
4102,城東区,165655,79367,86288,75563,2009-09-01
4103,鶴見区,110861,53267,57594,44997,2009-09-01
4104,阿倍野区,106624,49147,57477,48988,2009-09-01
4105,住吉区,156401,73541,82860,73612,2009-09-01
4106,東住吉区,131867,62471,69396,60282,2009-09-01
4107,平野区,200294,95281,105013,86126,2009-09-01
4108,西成区,124659,73360,51299,75019,2009-09-01
4109,東成区,79646,38065,41581,38216,2009-09-01
4110,住之江区,127570,61224,66346,56205,2009-09-01
4111,東淀川区,177047,87428,89619,91858,2009-09-01
4112,淀川区,171874,85012,86862,90338,2009-09-01
4113,西淀川区,97413,48278,49135,43279,2009-09-01
4114,北区,107814,51659,56155,62871,2009-09-01
4115,都島区,102064,49294,52770,49477,2009-09-01
4116,福島区,65819,31171,34648,33209,2009-09-01
4117,此花区,64906,31596,33310,28982,2009-09-01
4118,中央区,75999,35616,40383,47277,2009-09-01
4119,大阪市,2659693,1292007,1367686,1305002,2009-09-01
4120,港区,84904,41652,43252,40391,2009-09-01
4121,大正区,70469,34675,35794,30758,2009-09-01
4122,天王寺区,68481,31670,36811,33931,2009-09-01
4123,浪速区,60176,30606,29570,40699,2009-09-01
4124,西区,81215,38447,42768,46350,2009-09-01
4125,生野区,134710,64502,70208,62649,2009-10-01
4126,旭区,93023,44571,48452,43883,2009-10-01
4127,城東区,165640,79359,86281,75563,2009-10-01
4128,鶴見区,110899,53275,57624,45030,2009-10-01
4129,阿倍野区,106590,49132,57458,48961,2009-10-01
4130,住吉区,156301,73465,82836,73622,2009-10-01
4131,東住吉区,131720,62386,69334,60247,2009-10-01
4132,平野区,200214,95234,104980,86115,2009-10-01
4133,西成区,124485,73262,51223,75032,2009-10-01
4134,東成区,79674,38091,41583,38272,2009-10-01
4135,住之江区,127529,61221,66308,56231,2009-10-01
4136,東淀川区,177003,87384,89619,91831,2009-10-01
4137,淀川区,171864,85024,86840,90346,2009-10-01
4138,西淀川区,97391,48275,49116,43303,2009-10-01
4139,北区,107935,51688,56247,62972,2009-10-01
4140,都島区,102101,49312,52789,49500,2009-10-01
4141,福島区,65879,31192,34687,33251,2009-10-01
4142,此花区,64967,31629,33338,29033,2009-10-01
4143,中央区,76120,35657,40463,47344,2009-10-01
4144,大阪市,2659796,1291950,1367846,1305639,2009-10-01
4145,港区,85012,41706,43306,40445,2009-10-01
4146,大正区,70436,34655,35781,30756,2009-10-01
4147,天王寺区,68801,31819,36982,34090,2009-10-01
4148,浪速区,60256,30659,29597,40789,2009-10-01
4149,西区,81246,38452,42794,46374,2009-10-01
4150,東成区,79787,38150,41637,38352,2009-11-01
4151,生野区,134713,64507,70206,62681,2009-11-01
4152,旭区,92935,44519,48416,43860,2009-11-01
4153,城東区,165562,79320,86242,75515,2009-11-01
4154,鶴見区,110977,53303,57674,45060,2009-11-01
4155,住之江区,127558,61256,66302,56268,2009-11-01
4156,住吉区,156267,73486,82781,73648,2009-11-01
4157,東住吉区,131668,62384,69284,60245,2009-11-01
4158,平野区,200264,95272,104992,86124,2009-11-01
4159,東淀川区,176879,87295,89584,91730,2009-11-01
4160,阿倍野区,106544,49101,57443,48983,2009-11-01
4161,淀川区,171951,85111,86840,90460,2009-11-01
4162,西成区,124344,73199,51145,75049,2009-11-01
4163,浪速区,60419,30739,29680,40876,2009-11-01
4164,大阪市,2661153,1292769,1368384,1306796,2009-11-01
4165,北区,108205,51809,56396,63197,2009-11-01
4166,都島区,102109,49333,52776,49518,2009-11-01
4167,福島区,65893,31196,34697,33290,2009-11-01
4168,此花区,65439,31907,33532,29303,2009-11-01
4169,西淀川区,97494,48317,49177,43382,2009-11-01
4170,西区,81461,38561,42900,46433,2009-11-01
4171,港区,85078,41745,43333,40500,2009-11-01
4172,大正区,70378,34625,35753,30762,2009-11-01
4173,天王寺区,68928,31878,37050,34138,2009-11-01
4174,中央区,76300,35756,40544,47422,2009-11-01
4175,生野区,134631,64491,70140,62672,2009-12-01
4176,旭区,92878,44476,48402,43828,2009-12-01
4177,城東区,165697,79393,86304,75585,2009-12-01
4178,鶴見区,110989,53313,57676,45071,2009-12-01
4179,阿倍野区,106523,49092,57431,48972,2009-12-01
4180,住吉区,156269,73570,82699,73692,2009-12-01
4181,東住吉区,131613,62359,69254,60255,2009-12-01
4182,平野区,200261,95269,104992,86179,2009-12-01
4183,西成区,124109,73046,51063,75030,2009-12-01
4184,東成区,79823,38191,41632,38386,2009-12-01
4185,住之江区,127498,61219,66279,56291,2009-12-01
4186,東淀川区,176866,87285,89581,91703,2009-12-01
4187,淀川区,171878,85089,86789,90423,2009-12-01
4188,西淀川区,97530,48329,49201,43426,2009-12-01
4189,北区,108342,51870,56472,63347,2009-12-01
4190,都島区,102052,49302,52750,49505,2009-12-01
4191,福島区,65938,31219,34719,33340,2009-12-01
4192,此花区,65484,31923,33561,29324,2009-12-01
4193,中央区,76397,35819,40578,47494,2009-12-01
4194,大阪市,2661183,1292779,1368404,1307331,2009-12-01
4195,港区,85069,41756,43313,40503,2009-12-01
4196,大正区,70266,34549,35717,30720,2009-12-01
4197,天王寺区,69062,31926,37136,34202,2009-12-01
4198,浪速区,60482,30723,29759,40966,2009-12-01
4199,西区,81526,38570,42956,46417,2009-12-01
4200,東成区,79871,38214,41657,38403,2010-01-01
4201,生野区,134605,64487,70118,62701,2010-01-01
4202,旭区,92759,44436,48323,43798,2010-01-01
4203,城東区,165737,79446,86291,75602,2010-01-01
4204,鶴見区,111006,53327,57679,45055,2010-01-01
4205,住之江区,127482,61220,66262,56295,2010-01-01
4206,住吉区,156180,73557,82623,73692,2010-01-01
4207,東住吉区,131486,62304,69182,60183,2010-01-01
4208,平野区,200295,95257,105038,86230,2010-01-01
4209,東淀川区,176714,87177,89537,91613,2010-01-01
4210,阿倍野区,106531,49079,57452,49004,2010-01-01
4211,淀川区,172046,85194,86852,90461,2010-01-01
4212,西成区,123822,72836,50986,74884,2010-01-01
4213,浪速区,60628,30781,29847,41114,2010-01-01
4214,大阪市,2661391,1292864,1368527,1307647,2010-01-01
4215,北区,108382,51900,56482,63350,2010-01-01
4216,都島区,102097,49334,52763,49532,2010-01-01
4217,福島区,66111,31304,34807,33424,2010-01-01
4218,此花区,65426,31883,33543,29322,2010-01-01
4219,西淀川区,97554,48341,49213,43438,2010-01-01
4220,西区,81612,38593,43019,46404,2010-01-01
4221,港区,85091,41792,43299,40542,2010-01-01
4222,大正区,70223,34523,35700,30710,2010-01-01
4223,天王寺区,69212,31991,37221,34275,2010-01-01
4224,中央区,76521,35888,40633,47615,2010-01-01
4225,東成区,79852,38187,41665,38387,2010-02-01
4226,生野区,134495,64439,70056,62637,2010-02-01
4227,旭区,92684,44391,48293,43768,2010-02-01
4228,城東区,165760,79464,86296,75625,2010-02-01
4229,鶴見区,111040,53303,57737,45059,2010-02-01
4230,住之江区,127430,61178,66252,56292,2010-02-01
4231,住吉区,156026,73507,82519,73664,2010-02-01
4232,東住吉区,131319,62245,69074,60124,2010-02-01
4233,平野区,200250,95245,105005,86196,2010-02-01
4234,東淀川区,176663,87115,89548,91600,2010-02-01
4235,阿倍野区,106541,49079,57462,49017,2010-02-01
4236,淀川区,172002,85098,86904,90429,2010-02-01
4237,西成区,123530,72679,50851,74760,2010-02-01
4238,浪速区,60673,30785,29888,41177,2010-02-01
4239,大阪市,2660934,1292464,1368470,1307542,2010-02-01
4240,北区,108458,51908,56550,63335,2010-02-01
4241,都島区,102238,49395,52843,49584,2010-02-01
4242,福島区,66200,31341,34859,33495,2010-02-01
4243,此花区,65392,31870,33522,29292,2010-02-01
4244,西淀川区,97560,48338,49222,43465,2010-02-01
4245,西区,81659,38637,43022,46384,2010-02-01
4246,港区,85069,41778,43291,40553,2010-02-01
4247,大正区,70116,34460,35656,30686,2010-02-01
4248,天王寺区,69307,32050,37257,34302,2010-02-01
4249,中央区,76670,35972,40698,47711,2010-02-01
4250,東成区,79846,38196,41650,38409,2010-03-01
4251,生野区,134379,64386,69993,62644,2010-03-01
4252,旭区,92583,44338,48245,43725,2010-03-01
4253,城東区,165751,79486,86265,75642,2010-03-01
4254,鶴見区,111094,53330,57764,45066,2010-03-01
4255,住之江区,127357,61160,66197,56311,2010-03-01
4256,住吉区,155879,73435,82444,73666,2010-03-01
4257,東住吉区,131232,62213,69019,60111,2010-03-01
4258,平野区,200223,95246,104977,86193,2010-03-01
4259,東淀川区,176691,87116,89575,91616,2010-03-01
4260,阿倍野区,106404,48994,57410,49007,2010-03-01
4261,西成区,123348,72579,50769,74648,2010-03-01
4262,淀川区,171891,85053,86838,90400,2010-03-01
4263,浪速区,60691,30789,29902,41248,2010-03-01
4264,西淀川区,97541,48343,49198,43436,2010-03-01
4265,大阪市,2660505,1292259,1368246,1307922,2010-03-01
4266,北区,108485,51895,56590,63416,2010-03-01
4267,福島区,66267,31366,34901,33568,2010-03-01
4268,此花区,65463,31891,33572,29322,2010-03-01
4269,都島区,102360,49446,52914,49689,2010-03-01
4270,西区,81694,38670,43024,46367,2010-03-01
4271,港区,85073,41788,43285,40579,2010-03-01
4272,大正区,70080,34430,35650,30691,2010-03-01
4273,天王寺区,69356,32084,37272,34344,2010-03-01
4274,中央区,76817,36025,40792,47824,2010-03-01
4275,城東区,165772,79448,86324,75758,2010-04-01
4276,東成区,79904,38244,41660,38534,2010-04-01
4277,生野区,134226,64320,69906,62643,2010-04-01
4278,旭区,92520,44314,48206,43770,2010-04-01
4279,鶴見区,110969,53237,57732,45071,2010-04-01
4280,東淀川区,176618,87031,89587,91804,2010-04-01
4281,住之江区,127253,61082,66171,56395,2010-04-01
4282,住吉区,155688,73272,82416,73711,2010-04-01
4283,東住吉区,131168,62127,69041,60185,2010-04-01
4284,平野区,200000,95100,104900,86239,2010-04-01
4285,阿倍野区,106355,48952,57403,49054,2010-04-01
4286,淀川区,171955,85104,86851,90691,2010-04-01
4287,西成区,123130,72459,50671,74578,2010-04-01
4288,浪速区,61021,30940,30081,41519,2010-04-01
4289,大阪市,2660891,1291889,1369002,1310724,2010-04-01
4290,北区,109018,52106,56912,63971,2010-04-01
4291,都島区,102367,49420,52947,49771,2010-04-01
4292,福島区,66424,31403,35021,33727,2010-04-01
4293,此花区,65528,31903,33625,29387,2010-04-01
4294,西淀川区,97444,48286,49158,43466,2010-04-01
4295,西区,81882,38735,43147,46518,2010-04-01
4296,港区,84993,41729,43264,40608,2010-04-01
4297,大正区,70011,34391,35620,30714,2010-04-01
4298,天王寺区,69417,32094,37323,34434,2010-04-01
4299,中央区,77228,36192,41036,48176,2010-04-01
4300,生野区,134341,64363,69978,62769,2010-05-01
4301,旭区,92624,44355,48269,43877,2010-05-01
4302,城東区,165915,79525,86390,75919,2010-05-01
4303,鶴見区,111082,53277,57805,45175,2010-05-01
4304,阿倍野区,106419,49008,57411,49206,2010-05-01
4305,住吉区,155794,73302,82492,73895,2010-05-01
4306,東住吉区,131165,62135,69030,60245,2010-05-01
4307,平野区,199998,95094,104904,86302,2010-05-01
4308,西成区,122916,72331,50585,74510,2010-05-01
4309,東成区,80131,38380,41751,38749,2010-05-01
4310,住之江区,127387,61094,66293,56513,2010-05-01
4311,東淀川区,176794,87097,89697,91984,2010-05-01
4312,淀川区,171994,85133,86861,90847,2010-05-01
4313,西淀川区,97551,48378,49173,43538,2010-05-01
4314,北区,109773,52450,57323,64544,2010-05-01
4315,都島区,102522,49476,53046,49917,2010-05-01
4316,福島区,66674,31532,35142,33949,2010-05-01
4317,此花区,65615,31934,33681,29461,2010-05-01
4318,中央区,77637,36367,41270,48478,2010-05-01
4319,大阪市,2664515,1293637,1370878,1314413,2010-05-01
4320,港区,85100,41821,43279,40700,2010-05-01
4321,大正区,69927,34337,35590,30695,2010-05-01
4322,天王寺区,69602,32188,37414,34576,2010-05-01
4323,浪速区,61331,31163,30168,41815,2010-05-01
4324,西区,82223,38897,43326,46749,2010-05-01
4325,生野区,134285,64319,69966,62786,2010-06-01
4326,旭区,92515,44297,48218,43832,2010-06-01
4327,城東区,165971,79548,86423,75974,2010-06-01
4328,鶴見区,111109,53275,57834,45214,2010-06-01
4329,阿倍野区,106372,48992,57380,49222,2010-06-01
4330,住吉区,155754,73243,82511,73901,2010-06-01
4331,東住吉区,131053,62078,68975,60175,2010-06-01
4332,平野区,199973,95096,104877,86327,2010-06-01
4333,西成区,122730,72259,50471,74499,2010-06-01
4334,東成区,80196,38402,41794,38814,2010-06-01
4335,住之江区,127494,61139,66355,56598,2010-06-01
4336,東淀川区,176712,87038,89674,91980,2010-06-01
4337,淀川区,172024,85122,86902,90907,2010-06-01
4338,西淀川区,97537,48353,49184,43550,2010-06-01
4339,北区,109918,52503,57415,64646,2010-06-01
4340,都島区,102622,49532,53090,49978,2010-06-01
4341,福島区,66837,31622,35215,34080,2010-06-01
4342,此花区,65573,31919,33654,29442,2010-06-01
4343,中央区,77854,36481,41373,48599,2010-06-01
4344,大阪市,2665040,1293795,1371245,1315315,2010-06-01
4345,港区,85074,41820,43254,40714,2010-06-01
4346,大正区,69875,34302,35573,30632,2010-06-01
4347,天王寺区,69654,32233,37421,34601,2010-06-01
4348,浪速区,61352,31160,30192,41937,2010-06-01
4349,西区,82556,39062,43494,46907,2010-06-01
4350,生野区,134260,64314,69946,62844,2010-07-01
4351,旭区,92523,44316,48207,43852,2010-07-01
4352,城東区,165909,79513,86396,75985,2010-07-01
4353,鶴見区,111125,53283,57842,45220,2010-07-01
4354,阿倍野区,106349,48994,57355,49241,2010-07-01
4355,住吉区,155685,73195,82490,73915,2010-07-01
4356,東住吉区,130962,62018,68944,60143,2010-07-01
4357,平野区,199906,95030,104876,86341,2010-07-01
4358,西成区,122530,72163,50367,74522,2010-07-01
4359,東成区,80257,38406,41851,38871,2010-07-01
4360,住之江区,127440,61114,66326,56602,2010-07-01
4361,東淀川区,176770,87079,89691,92039,2010-07-01
4362,淀川区,172057,85125,86932,90954,2010-07-01
4363,西淀川区,97579,48351,49228,43589,2010-07-01
4364,北区,110016,52545,57471,64823,2010-07-01
4365,都島区,102644,49533,53111,50015,2010-07-01
4366,福島区,66942,31673,35269,34163,2010-07-01
4367,此花区,65499,31909,33590,29453,2010-07-01
4368,中央区,78020,36562,41458,48713,2010-07-01
4369,大阪市,2665233,1293871,1371362,1316352,2010-07-01
4370,港区,85038,41825,43213,40707,2010-07-01
4371,大正区,69800,34262,35538,30618,2010-07-01
4372,天王寺区,69695,32297,37398,34652,2010-07-01
4373,浪速区,61558,31248,30310,42103,2010-07-01
4374,西区,82669,39116,43553,46987,2010-07-01
4375,生野区,134171,64263,69908,62804,2010-08-01
4376,旭区,92463,44287,48176,43829,2010-08-01
4377,城東区,165893,79551,86342,76013,2010-08-01
4378,鶴見区,111084,53253,57831,45171,2010-08-01
4379,阿倍野区,106345,48997,57348,49272,2010-08-01
4380,住吉区,155641,73194,82447,73881,2010-08-01
4381,東住吉区,130896,62014,68882,60115,2010-08-01
4382,平野区,199904,95032,104872,86383,2010-08-01
4383,西成区,122338,72082,50256,74537,2010-08-01
4384,東成区,80257,38420,41837,38872,2010-08-01
4385,住之江区,127443,61113,66330,56631,2010-08-01
4386,東淀川区,176706,87007,89699,92037,2010-08-01
4387,淀川区,172082,85125,86957,91043,2010-08-01
4388,西淀川区,97591,48368,49223,43614,2010-08-01
4389,北区,110154,52635,57519,64951,2010-08-01
4390,都島区,102648,49539,53109,50041,2010-08-01
4391,福島区,67051,31716,35335,34246,2010-08-01
4392,此花区,65533,31909,33624,29472,2010-08-01
4393,中央区,78236,36673,41563,48825,2010-08-01
4394,大阪市,2665515,1294101,1371414,1317058,2010-08-01
4395,港区,85056,41849,43207,40731,2010-08-01
4396,大正区,69713,34227,35486,30594,2010-08-01
4397,天王寺区,69669,32287,37382,34657,2010-08-01
4398,浪速区,61775,31343,30432,42264,2010-08-01
4399,西区,82866,39217,43649,47075,2010-08-01
4400,生野区,134065,64209,69856,62805,2010-09-01
4401,旭区,92464,44292,48172,43822,2010-09-01
4402,城東区,165870,79522,86348,76035,2010-09-01
4403,鶴見区,111140,53282,57858,45216,2010-09-01
4404,阿倍野区,106373,49019,57354,49290,2010-09-01
4405,住吉区,155667,73222,82445,73913,2010-09-01
4406,東住吉区,130818,61953,68865,60117,2010-09-01
4407,平野区,199912,95019,104893,86432,2010-09-01
4408,西成区,122184,71993,50191,74501,2010-09-01
4409,東成区,80257,38437,41820,38896,2010-09-01
4410,住之江区,127316,61059,66257,56616,2010-09-01
4411,東淀川区,176570,86972,89598,92020,2010-09-01
4412,淀川区,172142,85118,87024,91145,2010-09-01
4413,西淀川区,97549,48334,49215,43597,2010-09-01
4414,北区,110310,52717,57593,65100,2010-09-01
4415,都島区,102663,49547,53116,50077,2010-09-01
4416,福島区,67215,31799,35416,34342,2010-09-01
4417,此花区,65584,31973,33611,29486,2010-09-01
4418,中央区,78474,36793,41681,48951,2010-09-01
4419,大阪市,2665777,1294245,1371532,1317768,2010-09-01
4420,港区,84981,41789,43192,40713,2010-09-01
4421,大正区,69632,34200,35432,30558,2010-09-01
4422,天王寺区,69734,32322,37412,34707,2010-09-01
4423,浪速区,61838,31366,30472,42304,2010-09-01
4424,西区,83019,39308,43711,47125,2010-09-01
4425,生野区,134009,64191,69818,62808,2010-10-01
4426,旭区,92455,44289,48166,43842,2010-10-01
4427,城東区,165832,79519,86313,76043,2010-10-01
4428,鶴見区,111182,53279,57903,45264,2010-10-01
4429,阿倍野区,106350,49015,57335,49318,2010-10-01
4430,住吉区,155572,73145,82427,73917,2010-10-01
4431,東住吉区,130724,61923,68801,60057,2010-10-01
4432,平野区,200005,95072,104933,86500,2010-10-01
4433,西成区,121972,71871,50101,74466,2010-10-01
4434,東成区,80231,38410,41821,38920,2010-10-01
4435,住之江区,127210,61007,66203,56593,2010-10-01
4436,東淀川区,176585,86952,89633,91894,2010-10-01
4437,淀川区,172078,85078,87000,91116,2010-10-01
4438,西淀川区,97504,48303,49201,43608,2010-10-01
4439,北区,110392,52754,57638,65204,2010-10-01
4440,都島区,102632,49534,53098,50075,2010-10-01
4441,福島区,67290,31818,35472,34379,2010-10-01
4442,此花区,65569,31949,33620,29495,2010-10-01
4443,中央区,78687,36885,41802,49062,2010-10-01
4444,大阪市,2665314,1293798,1371516,1317990,2010-10-01
4445,港区,84947,41761,43186,40713,2010-10-01
4446,大正区,69510,34147,35363,30521,2010-10-01
4447,天王寺区,69775,32307,37468,34730,2010-10-01
4448,浪速区,61745,31306,30439,42392,2010-10-01
4449,西区,83058,39283,43775,47073,2010-10-01
4450,生野区,133914,64169,69745,62810,2010-11-01
4451,旭区,92474,44296,48178,43868,2010-11-01
4452,城東区,165838,79525,86313,76003,2010-11-01
4453,鶴見区,111150,53272,57878,45251,2010-11-01
4454,阿倍野区,106382,49016,57366,49302,2010-11-01
4455,住吉区,155542,73119,82423,73907,2010-11-01
4456,東住吉区,130651,61865,68786,59984,2010-11-01
4457,平野区,200069,95103,104966,86562,2010-11-01
4458,西成区,121916,71812,50104,74429,2010-11-01
4459,東成区,80196,38401,41795,38893,2010-11-01
4460,住之江区,127198,60999,66199,56622,2010-11-01
4461,東淀川区,176563,86933,89630,91866,2010-11-01
4462,淀川区,172093,85063,87030,91129,2010-11-01
4463,西淀川区,97509,48301,49208,43596,2010-11-01
4464,北区,110636,52916,57720,65343,2010-11-01
4465,都島区,102695,49599,53096,50093,2010-11-01
4466,福島区,67388,31862,35526,34405,2010-11-01
4467,此花区,65612,31973,33639,29498,2010-11-01
4468,中央区,78810,36935,41875,49152,2010-11-01
4469,大阪市,2665914,1294085,1371829,1318226,2010-11-01
4470,港区,84899,41764,43135,40700,2010-11-01
4471,大正区,69435,34117,35318,30495,2010-11-01
4472,天王寺区,69868,32342,37526,34752,2010-11-01
4473,浪速区,61851,31357,30494,42440,2010-11-01
4474,西区,83225,39346,43879,47126,2010-11-01
4475,東成区,80081,38349,41732,38857,2010-12-01
4476,生野区,133746,64105,69641,62812,2010-12-01
4477,旭区,92439,44268,48171,43851,2010-12-01
4478,城東区,165739,79476,86263,75967,2010-12-01
4479,鶴見区,111132,53266,57866,45251,2010-12-01
4480,住之江区,127174,60984,66190,56643,2010-12-01
4481,住吉区,155477,73109,82368,73892,2010-12-01
4482,東住吉区,130543,61804,68739,59918,2010-12-01
4483,平野区,199983,95067,104916,86588,2010-12-01
4484,東淀川区,176436,86832,89604,91726,2010-12-01
4485,阿倍野区,106426,49046,57380,49300,2010-12-01
4486,淀川区,172148,85103,87045,91117,2010-12-01
4487,西成区,121739,71680,50059,74393,2010-12-01
4488,浪速区,61884,31373,30511,42490,2010-12-01
4489,大阪市,2665362,1293770,1371592,1318157,2010-12-01
4490,北区,110683,52971,57712,65342,2010-12-01
4491,都島区,102815,49649,53166,50160,2010-12-01
4492,福島区,67453,31890,35563,34437,2010-12-01
4493,此花区,65637,31981,33656,29499,2010-12-01
4494,西淀川区,97531,48319,49212,43579,2010-12-01
4495,西区,83372,39418,43954,47193,2010-12-01
4496,港区,84858,41725,43133,40707,2010-12-01
4497,大正区,69359,34073,35286,30457,2010-12-01
4498,天王寺区,69947,32390,37557,34799,2010-12-01
4499,中央区,78760,36892,41868,49179,2010-12-01
4500,生野区,133688,64066,69622,62844,2011-01-01
4501,旭区,92494,44285,48209,43859,2011-01-01
4502,城東区,165570,79391,86179,75880,2011-01-01
4503,鶴見区,111117,53245,57872,45218,2011-01-01
4504,阿倍野区,106400,49013,57387,49300,2011-01-01
4505,住吉区,155467,73117,82350,73845,2011-01-01
4506,東住吉区,130522,61796,68726,59891,2011-01-01
4507,平野区,199823,94966,104857,86563,2011-01-01
4508,西成区,121498,71507,49991,74203,2011-01-01
4509,東成区,80082,38354,41728,38820,2011-01-01
4510,住之江区,127097,60980,66117,56630,2011-01-01
4511,東淀川区,176392,86803,89589,91661,2011-01-01
4512,淀川区,172041,85065,86976,91093,2011-01-01
4513,西淀川区,97562,48324,49238,43469,2011-01-01
4514,北区,110676,52975,57701,65363,2011-01-01
4515,都島区,102827,49658,53169,50141,2011-01-01
4516,福島区,67489,31900,35589,34456,2011-01-01
4517,此花区,65644,32012,33632,29527,2011-01-01
4518,中央区,78763,36891,41872,49147,2011-01-01
4519,大阪市,2664849,1293431,1371418,1317753,2011-01-01
4520,港区,84782,41668,43114,40658,2011-01-01
4521,大正区,69352,34051,35301,30456,2011-01-01
4522,天王寺区,70026,32409,37617,34832,2011-01-01
4523,浪速区,62021,31459,30562,42601,2011-01-01
4524,西区,83516,39496,44020,47296,2011-01-01
4525,生野区,133594,64050,69544,62825,2011-02-01
4526,旭区,92457,44253,48204,43823,2011-02-01
4527,城東区,165483,79331,86152,75813,2011-02-01
4528,鶴見区,111100,53237,57863,45191,2011-02-01
4529,阿倍野区,106253,48970,57283,49251,2011-02-01
4530,住吉区,155322,73034,82288,73757,2011-02-01
4531,東住吉区,130358,61701,68657,59803,2011-02-01
4532,平野区,199772,94905,104867,86585,2011-02-01
4533,西成区,121250,71342,49908,74080,2011-02-01
4534,東成区,80057,38339,41718,38783,2011-02-01
4535,住之江区,127066,60958,66108,56610,2011-02-01
4536,東淀川区,176281,86734,89547,91617,2011-02-01
4537,淀川区,171964,84999,86965,91018,2011-02-01
4538,西淀川区,97484,48305,49179,43424,2011-02-01
4539,北区,110774,53043,57731,65407,2011-02-01
4540,都島区,102804,49623,53181,50062,2011-02-01
4541,福島区,67532,31924,35608,34448,2011-02-01
4542,此花区,65639,31995,33644,29506,2011-02-01
4543,中央区,78900,36988,41912,49185,2011-02-01
4544,大阪市,2663863,1292870,1370993,1317067,2011-02-01
4545,港区,84755,41658,43097,40647,2011-02-01
4546,大正区,69298,34016,35282,30452,2011-02-01
4547,天王寺区,70043,32420,37623,34813,2011-02-01
4548,浪速区,62100,31526,30574,42676,2011-02-01
4549,西区,83577,39519,44058,47291,2011-02-01
4550,生野区,133494,64055,69439,62811,2011-03-01
4551,旭区,92378,44233,48145,43775,2011-03-01
4552,城東区,165455,79314,86141,75752,2011-03-01
4553,鶴見区,111066,53211,57855,45175,2011-03-01
4554,阿倍野区,106187,48936,57251,49267,2011-03-01
4555,住吉区,155223,72969,82254,73680,2011-03-01
4556,東住吉区,130257,61648,68609,59744,2011-03-01
4557,平野区,199785,94912,104873,86634,2011-03-01
4558,西成区,121037,71219,49818,73961,2011-03-01
4559,東成区,80042,38323,41719,38780,2011-03-01
4560,住之江区,126955,60889,66066,56546,2011-03-01
4561,東淀川区,176215,86699,89516,91562,2011-03-01
4562,淀川区,171811,84927,86884,90922,2011-03-01
4563,西淀川区,97431,48276,49155,43401,2011-03-01
4564,北区,110952,53137,57815,65396,2011-03-01
4565,都島区,102852,49680,53172,50066,2011-03-01
4566,福島区,67554,31922,35632,34430,2011-03-01
4567,此花区,65654,32005,33649,29517,2011-03-01
4568,中央区,79108,37065,42043,49378,2011-03-01
4569,大阪市,2663098,1292432,1370666,1316626,2011-03-01
4570,港区,84719,41617,43102,40633,2011-03-01
4571,大正区,69169,33942,35227,30424,2011-03-01
4572,天王寺区,70027,32415,37612,34783,2011-03-01
4573,浪速区,62088,31501,30587,42687,2011-03-01
4574,西区,83639,39537,44102,47302,2011-03-01
4575,東成区,80154,38360,41794,38929,2011-04-01
4576,生野区,133306,63963,69343,62886,2011-04-01
4577,旭区,92370,44223,48147,43833,2011-04-01
4578,城東区,165433,79289,86144,75938,2011-04-01
4579,鶴見区,110867,53099,57768,45163,2011-04-01
4580,住之江区,126689,60720,65969,56504,2011-04-01
4581,住吉区,155185,72921,82264,73758,2011-04-01
4582,東住吉区,130091,61545,68546,59709,2011-04-01
4583,平野区,199604,94821,104783,86751,2011-04-01
4584,東淀川区,176160,86599,89561,91761,2011-04-01
4585,阿倍野区,106046,48832,57214,49280,2011-04-01
4586,淀川区,171939,84909,87030,91169,2011-04-01
4587,西成区,120847,71107,49740,73957,2011-04-01
4588,浪速区,62358,31628,30730,42963,2011-04-01
4589,大阪市,2663516,1292035,1371481,1319548,2011-04-01
4590,北区,111212,53214,57998,65674,2011-04-01
4591,都島区,102859,49666,53193,50189,2011-04-01
4592,福島区,68071,32164,35907,34782,2011-04-01
4593,此花区,65600,31967,33633,29568,2011-04-01
4594,西淀川区,97410,48270,49140,43490,2011-04-01
4595,西区,83863,39619,44244,47520,2011-04-01
4596,港区,84633,41549,43084,40670,2011-04-01
4597,大正区,68988,33833,35155,30424,2011-04-01
4598,天王寺区,70235,32473,37762,34928,2011-04-01
4599,中央区,79596,37264,42332,49702,2011-04-01
4600,生野区,133248,63966,69282,63002,2011-05-01
4601,旭区,92371,44189,48182,43868,2011-05-01
4602,城東区,165501,79359,86142,76045,2011-05-01
4603,鶴見区,110840,53104,57736,45169,2011-05-01
4604,阿倍野区,106185,48904,57281,49411,2011-05-01
4605,住吉区,155357,72997,82360,73842,2011-05-01
4606,東住吉区,130199,61626,68573,59780,2011-05-01
4607,平野区,199574,94790,104784,86820,2011-05-01
4608,西成区,120836,71083,49753,73963,2011-05-01
4609,東成区,80344,38463,41881,39068,2011-05-01
4610,住之江区,126692,60748,65944,56563,2011-05-01
4611,東淀川区,176525,86755,89770,92024,2011-05-01
4612,淀川区,172333,85153,87180,91481,2011-05-01
4613,西淀川区,97434,48298,49136,43568,2011-05-01
4614,北区,111672,53466,58206,66032,2011-05-01
4615,都島区,102993,49725,53268,50343,2011-05-01
4616,福島区,68327,32285,36042,34967,2011-05-01
4617,此花区,65682,31995,33687,29636,2011-05-01
4618,中央区,80133,37512,42621,50114,2011-05-01
4619,大阪市,2667035,1293830,1373205,1322778,2011-05-01
4620,港区,84549,41504,43045,40667,2011-05-01
4621,大正区,68957,33804,35153,30443,2011-05-01
4622,天王寺区,70466,32584,37882,35044,2011-05-01
4623,浪速区,62663,31749,30914,43180,2011-05-01
4624,西区,84154,39771,44383,47748,2011-05-01
4625,東成区,80393,38480,41913,39099,2011-06-01
4626,生野区,133071,63904,69167,63000,2011-06-01
4627,旭区,92354,44179,48175,43910,2011-06-01
4628,城東区,165468,79314,86154,76042,2011-06-01
4629,鶴見区,110799,53064,57735,45149,2011-06-01
4630,住之江区,126746,60776,65970,56599,2011-06-01
4631,住吉区,155355,73004,82351,73832,2011-06-01
4632,東住吉区,130143,61609,68534,59786,2011-06-01
4633,平野区,199567,94793,104774,86871,2011-06-01
4634,東淀川区,176495,86805,89690,92070,2011-06-01
4635,阿倍野区,106226,48908,57318,49460,2011-06-01
4636,淀川区,172549,85289,87260,91601,2011-06-01
4637,西成区,120695,70957,49738,73979,2011-06-01
4638,浪速区,62761,31801,30960,43232,2011-06-01
4639,大阪市,2668030,1294420,1373610,1323832,2011-06-01
4640,北区,111816,53533,58283,66168,2011-06-01
4641,都島区,103103,49761,53342,50379,2011-06-01
4642,福島区,68548,32402,36146,35112,2011-06-01
4643,此花区,65688,32020,33668,29651,2011-06-01
4644,西淀川区,97442,48308,49134,43531,2011-06-01
4645,西区,84302,39867,44435,47859,2011-06-01
4646,港区,84567,41507,43060,40612,2011-06-01
4647,大正区,68925,33780,35145,30430,2011-06-01
4648,天王寺区,70612,32681,37931,35102,2011-06-01
4649,中央区,80405,37678,42727,50358,2011-06-01
4650,東成区,80487,38522,41965,39159,2011-07-01
4651,生野区,133057,63893,69164,63014,2011-07-01
4652,旭区,92285,44135,48150,43879,2011-07-01
4653,城東区,165402,79302,86100,76029,2011-07-01
4654,鶴見区,110835,53050,57785,45159,2011-07-01
4655,住之江区,126615,60707,65908,56537,2011-07-01
4656,住吉区,155360,73008,82352,73776,2011-07-01
4657,東住吉区,129978,61522,68456,59706,2011-07-01
4658,平野区,199602,94818,104784,86941,2011-07-01
4659,東淀川区,176671,86895,89776,92115,2011-07-01
4660,阿倍野区,106175,48880,57295,49446,2011-07-01
4661,淀川区,172559,85298,87261,91616,2011-07-01
4662,西成区,120580,70878,49702,73968,2011-07-01
4663,浪速区,62794,31827,30967,43262,2011-07-01
4664,大阪市,2668460,1294555,1373905,1324296,2011-07-01
4665,北区,112000,53629,58371,66299,2011-07-01
4666,都島区,103136,49757,53379,50390,2011-07-01
4667,福島区,68737,32487,36250,35217,2011-07-01
4668,此花区,65662,32004,33658,29644,2011-07-01
4669,西淀川区,97442,48296,49146,43554,2011-07-01
4670,西区,84384,39929,44455,47905,2011-07-01
4671,港区,84564,41486,43078,40627,2011-07-01
4672,大正区,68806,33716,35090,30349,2011-07-01
4673,天王寺区,70663,32714,37949,35161,2011-07-01
4674,中央区,80666,37802,42864,50543,2011-07-01
4675,東成区,80451,38526,41925,39124,2011-08-01
4676,生野区,132971,63882,69089,63022,2011-08-01
4677,旭区,92241,44095,48146,43855,2011-08-01
4678,城東区,165377,79263,86114,76031,2011-08-01
4679,鶴見区,110793,53018,57775,45127,2011-08-01
4680,住之江区,126596,60705,65891,56558,2011-08-01
4681,住吉区,155428,72998,82430,73758,2011-08-01
4682,東住吉区,129916,61528,68388,59703,2011-08-01
4683,平野区,199548,94782,104766,86929,2011-08-01
4684,東淀川区,176669,86896,89773,92107,2011-08-01
4685,阿倍野区,106180,48854,57326,49472,2011-08-01
4686,西成区,120423,70778,49645,73954,2011-08-01
4687,淀川区,172510,85277,87233,91605,2011-08-01
4688,浪速区,62883,31883,31000,43301,2011-08-01
4689,西淀川区,97389,48283,49106,43535,2011-08-01
4690,大阪市,2668330,1294504,1373826,1324471,2011-08-01
4691,北区,112214,53737,58477,66437,2011-08-01
4692,福島区,68810,32543,36267,35232,2011-08-01
4693,此花区,65671,32003,33668,29655,2011-08-01
4694,都島区,103105,49736,53369,50358,2011-08-01
4695,西区,84444,39956,44488,47873,2011-08-01
4696,港区,84488,41448,43040,40613,2011-08-01
4697,大正区,68771,33690,35081,30340,2011-08-01
4698,天王寺区,70656,32732,37924,35192,2011-08-01
4699,中央区,80796,37891,42905,50690,2011-08-01
4700,城東区,165343,79245,86098,76046,2011-09-01
4701,東成区,80482,38557,41925,39159,2011-09-01
4702,生野区,132883,63854,69029,63057,2011-09-01
4703,旭区,92218,44117,48101,43869,2011-09-01
4704,鶴見区,110833,53051,57782,45160,2011-09-01
4705,東淀川区,176729,86928,89801,92117,2011-09-01
4706,住之江区,126477,60648,65829,56533,2011-09-01
4707,住吉区,155244,72905,82339,73631,2011-09-01
4708,東住吉区,129769,61447,68322,59611,2011-09-01
4709,平野区,199562,94788,104774,86986,2011-09-01
4710,阿倍野区,106340,48943,57397,49535,2011-09-01
4711,淀川区,172584,85348,87236,91606,2011-09-01
4712,西成区,120321,70697,49624,73940,2011-09-01
4713,浪速区,63027,32005,31022,43338,2011-09-01
4714,大阪市,2668999,1294969,1374030,1324994,2011-09-01
4715,北区,112496,53909,58587,66565,2011-09-01
4716,都島区,103174,49764,53410,50361,2011-09-01
4717,福島区,68898,32575,36323,35275,2011-09-01
4718,此花区,65858,32120,33738,29745,2011-09-01
4719,西淀川区,97407,48271,49136,43532,2011-09-01
4720,西区,84615,40035,44580,47964,2011-09-01
4721,港区,84410,41396,43014,40601,2011-09-01
4722,大正区,68664,33637,35027,30323,2011-09-01
4723,天王寺区,70744,32773,37971,35255,2011-09-01
4724,中央区,80921,37956,42965,50785,2011-09-01
4725,東成区,80437,38537,41900,39100,2011-10-01
4726,旭区,92188,44085,48103,43829,2011-10-01
4727,城東区,165266,79193,86073,76010,2011-10-01
4728,鶴見区,111053,53156,57897,45239,2011-10-01
4729,阿倍野区,106283,48898,57385,49498,2011-10-01
4730,住吉区,155188,72845,82343,73555,2011-10-01
4731,東淀川区,176719,86926,89793,92107,2011-10-01
4732,東住吉区,129664,61384,68280,59514,2011-10-01
4733,平野区,199482,94716,104766,86997,2011-10-01
4734,西成区,120186,70590,49596,73880,2011-10-01
4735,住之江区,126421,60635,65786,56546,2011-10-01
4736,淀川区,172415,85265,87150,91483,2011-10-01
4737,生野区,132884,63834,69050,63080,2011-10-01
4738,浪速区,63158,32043,31115,43399,2011-10-01
4739,西淀川区,97314,48203,49111,43457,2011-10-01
4740,北区,112643,54006,58637,66617,2011-10-01
4741,都島区,103190,49767,53423,50379,2011-10-01
4742,福島区,68905,32572,36333,35239,2011-10-01
4743,此花区,66163,32273,33890,29881,2011-10-01
4744,大阪市,2668972,1294751,1374221,1324740,2011-10-01
4745,西区,84663,40047,44616,47972,2011-10-01
4746,港区,84280,41321,42959,40565,2011-10-01
4747,大正区,68600,33595,35005,30300,2011-10-01
4748,天王寺区,70853,32850,38003,35293,2011-10-01
4749,中央区,81017,38010,43007,50800,2011-10-01
4750,東成区,80481,38551,41930,39138,2011-11-01
4751,旭区,92148,44064,48084,43770,2011-11-01
4752,城東区,165271,79196,86075,75988,2011-11-01
4753,鶴見区,111329,53314,58015,45352,2011-11-01
4754,阿倍野区,106338,48930,57408,49496,2011-11-01
4755,住吉区,155270,72881,82389,73568,2011-11-01
4756,東住吉区,129669,61382,68287,59505,2011-11-01
4757,平野区,199402,94683,104719,86959,2011-11-01
4758,西成区,120061,70517,49544,73783,2011-11-01
4759,東淀川区,176774,86964,89810,92164,2011-11-01
4760,住之江区,126407,60621,65786,56591,2011-11-01
4761,淀川区,172454,85321,87133,91471,2011-11-01
4762,生野区,132826,63818,69008,63043,2011-11-01
4763,浪速区,63253,32103,31150,43398,2011-11-01
4764,北区,112876,54107,58769,66772,2011-11-01
4765,都島区,103153,49754,53399,50340,2011-11-01
4766,福島区,68954,32587,36367,35245,2011-11-01
4767,此花区,66381,32361,34020,29969,2011-11-01
4768,中央区,81103,38046,43057,50869,2011-11-01
4769,大阪市,2670016,1295284,1374732,1325077,2011-11-01
4770,港区,84213,41297,42916,40537,2011-11-01
4771,西区,84771,40109,44662,48023,2011-11-01
4772,天王寺区,71017,32927,38090,35380,2011-11-01
4773,西淀川区,97319,48180,49139,43429,2011-11-01
4774,大正区,68546,33571,34975,30287,2011-11-01
4775,東淀川区,176785,86968,89817,92143,2011-12-01
4776,平野区,199466,94680,104786,87019,2011-12-01
4777,東住吉区,129544,61324,68220,59440,2011-12-01
4778,住吉区,155341,72931,82410,73561,2011-12-01
4779,阿倍野区,106360,48923,57437,49506,2011-12-01
4780,鶴見区,111417,53384,58033,45401,2011-12-01
4781,城東区,165150,79123,86027,75948,2011-12-01
4782,旭区,92082,44046,48036,43727,2011-12-01
4783,生野区,132729,63757,68972,63041,2011-12-01
4784,東成区,80496,38555,41941,39134,2011-12-01
4785,西成区,119817,70354,49463,73655,2011-12-01
4786,住之江区,126362,60588,65774,56590,2011-12-01
4787,淀川区,172530,85339,87191,91472,2011-12-01
4788,浪速区,63347,32134,31213,43409,2011-12-01
4789,西淀川区,97345,48208,49137,43422,2011-12-01
4790,大阪市,2670050,1295219,1374831,1325154,2011-12-01
4791,北区,112968,54172,58796,66854,2011-12-01
4792,福島区,69068,32652,36416,35316,2011-12-01
4793,此花区,66380,32346,34034,29939,2011-12-01
4794,都島区,103085,49719,53366,50309,2011-12-01
4795,西区,84858,40175,44683,48098,2011-12-01
4796,港区,84180,41262,42918,40567,2011-12-01
4797,大正区,68496,33548,34948,30275,2011-12-01
4798,天王寺区,71113,32975,38138,35404,2011-12-01
4799,中央区,81131,38056,43075,50924,2011-12-01
4800,城東区,165137,79115,86022,75953,2012-01-01
4801,東成区,80565,38585,41980,39156,2012-01-01
4802,生野区,132703,63743,68960,63031,2012-01-01
4803,旭区,92078,44024,48054,43722,2012-01-01
4804,鶴見区,111376,53350,58026,45415,2012-01-01
4805,東淀川区,176684,86932,89752,92081,2012-01-01
4806,住之江区,126319,60569,65750,56569,2012-01-01
4807,住吉区,155315,72939,82376,73515,2012-01-01
4808,東住吉区,129415,61246,68169,59342,2012-01-01
4809,平野区,199436,94656,104780,87039,2012-01-01
4810,阿倍野区,106357,48917,57440,49503,2012-01-01
4811,淀川区,172503,85335,87168,91427,2012-01-01
4812,西成区,119643,70218,49425,73551,2012-01-01
4813,浪速区,63393,32168,31225,43446,2012-01-01
4814,大阪市,2669671,1294890,1374781,1325034,2012-01-01
4815,北区,112990,54213,58777,66898,2012-01-01
4816,都島区,102999,49673,53326,50279,2012-01-01
4817,福島区,69107,32654,36453,35333,2012-01-01
4818,此花区,66304,32314,33990,29884,2012-01-01
4819,西淀川区,97258,48144,49114,43396,2012-01-01
4820,西区,85002,40221,44781,48165,2012-01-01
4821,港区,84152,41235,42917,40569,2012-01-01
4822,大正区,68432,33520,34912,30250,2012-01-01
4823,天王寺区,71211,33016,38195,35444,2012-01-01
4824,中央区,81292,38103,43189,51066,2012-01-01
4825,生野区,132563,63652,68911,62952,2012-02-01
4826,旭区,92088,44062,48026,43728,2012-02-01
4827,城東区,165178,79125,86053,75937,2012-02-01
4828,鶴見区,111371,53358,58013,45408,2012-02-01
4829,阿倍野区,106215,48871,57344,49462,2012-02-01
4830,住吉区,155189,72864,82325,73396,2012-02-01
4831,東住吉区,129353,61236,68117,59266,2012-02-01
4832,平野区,199391,94625,104766,87060,2012-02-01
4833,西成区,119399,70052,49347,73469,2012-02-01
4834,東成区,80489,38543,41946,39084,2012-02-01
4835,住之江区,126241,60545,65696,56573,2012-02-01
4836,東淀川区,176633,86946,89687,92029,2012-02-01
4837,福島区,69096,32655,36441,35325,2012-02-01
4838,西淀川区,97217,48088,49129,43354,2012-02-01
4839,北区,113117,54272,58845,66956,2012-02-01
4840,都島区,102987,49678,53309,50268,2012-02-01
4841,淀川区,172442,85328,87114,91348,2012-02-01
4842,此花区,66281,32306,33975,29867,2012-02-01
4843,中央区,81329,38136,43193,51157,2012-02-01
4844,大阪市,2668847,1294554,1374293,1324435,2012-02-01
4845,港区,84022,41172,42850,40534,2012-02-01
4846,大正区,68399,33498,34901,30218,2012-02-01
4847,天王寺区,71324,33084,38240,35525,2012-02-01
4848,浪速区,63397,32168,31229,43344,2012-02-01
4849,西区,85126,40290,44836,48175,2012-02-01
4850,東成区,80520,38532,41988,39108,2012-03-01
4851,生野区,132459,63621,68838,62979,2012-03-01
4852,旭区,91988,44001,47987,43652,2012-03-01
4853,城東区,165060,79061,85999,75868,2012-03-01
4854,鶴見区,111414,53354,58060,45445,2012-03-01
4855,住之江区,126132,60486,65646,56570,2012-03-01
4856,住吉区,155126,72861,82265,73274,2012-03-01
4857,東住吉区,129160,61124,68036,59193,2012-03-01
4858,平野区,199276,94546,104730,87073,2012-03-01
4859,東淀川区,176608,86960,89648,92011,2012-03-01
4860,阿倍野区,106231,48875,57356,49462,2012-03-01
4861,淀川区,172405,85292,87113,91310,2012-03-01
4862,西成区,119211,69920,49291,73359,2012-03-01
4863,浪速区,63451,32201,31250,43390,2012-03-01
4864,大阪市,2668054,1294003,1374051,1324178,2012-03-01
4865,北区,113189,54301,58888,66998,2012-03-01
4866,都島区,103021,49697,53324,50267,2012-03-01
4867,福島区,69106,32665,36441,35324,2012-03-01
4868,此花区,66279,32312,33967,29852,2012-03-01
4869,西淀川区,97150,48039,49111,43300,2012-03-01
4870,西区,85202,40303,44899,48226,2012-03-01
4871,港区,83969,41142,42827,40539,2012-03-01
4872,大正区,68292,33454,34838,30183,2012-03-01
4873,天王寺区,71395,33109,38286,35558,2012-03-01
4874,中央区,81410,38147,43263,51237,2012-03-01
4875,東成区,80512,38512,42000,39206,2012-04-01
4876,平野区,199163,94491,104672,87191,2012-04-01
4877,東住吉区,128953,60978,67975,59199,2012-04-01
4878,住吉区,154996,72771,82225,73275,2012-04-01
4879,住之江区,125907,60368,65539,56593,2012-04-01
4880,阿倍野区,106289,48907,57382,49541,2012-04-01
4881,鶴見区,111247,53257,57990,45448,2012-04-01
4882,城東区,164926,78952,85974,75949,2012-04-01
4883,旭区,91959,43964,47995,43656,2012-04-01
4884,生野区,132389,63533,68856,63065,2012-04-01
4885,東淀川区,176860,87017,89843,92394,2012-04-01
4886,西成区,118952,69754,49198,73232,2012-04-01
4887,淀川区,172371,85238,87133,91512,2012-04-01
4888,大阪市,2668288,1293400,1374888,1326698,2012-04-01
4889,北区,113484,54422,59062,67378,2012-04-01
4890,都島区,103418,49822,53596,50433,2012-04-01
4891,福島区,69149,32643,36506,35418,2012-04-01
4892,此花区,66291,32307,33984,29879,2012-04-01
4893,西淀川区,97021,47979,49042,43322,2012-04-01
4894,西区,85449,40405,45044,48506,2012-04-01
4895,港区,83831,41047,42784,40543,2012-04-01
4896,大正区,68131,33363,34768,30140,2012-04-01
4897,天王寺区,71628,33155,38473,35781,2012-04-01
4898,浪速区,63647,32293,31354,43503,2012-04-01
4899,中央区,81715,38222,43493,51534,2012-04-01
4900,東成区,80641,38589,42052,39327,2012-05-01
4901,生野区,132480,63555,68925,63171,2012-05-01
4902,旭区,92030,44019,48011,43715,2012-05-01
4903,城東区,165054,79021,86033,76050,2012-05-01
4904,鶴見区,111454,53357,58097,45592,2012-05-01
4905,住吉区,155126,72834,82292,73363,2012-05-01
4906,住之江区,125944,60401,65543,56687,2012-05-01
4907,東住吉区,128959,61007,67952,59208,2012-05-01
4908,平野区,199246,94558,104688,87311,2012-05-01
4909,東淀川区,177134,87182,89952,92643,2012-05-01
4910,阿倍野区,106453,48995,57458,49657,2012-05-01
4911,西成区,118839,69668,49171,73170,2012-05-01
4912,西淀川区,97134,48046,49088,43420,2012-05-01
4913,浪速区,63931,32460,31471,43698,2012-05-01
4914,淀川区,172701,85434,87267,91773,2012-05-01
4915,大阪市,2672357,1295620,1376737,1330090,2012-05-01
4916,北区,113924,54680,59244,67799,2012-05-01
4917,福島区,69369,32755,36614,35600,2012-05-01
4918,此花区,66304,32304,34000,29927,2012-05-01
4919,都島区,103915,50066,53849,50696,2012-05-01
4920,西区,85693,40498,45195,48701,2012-05-01
4921,港区,83777,41028,42749,40554,2012-05-01
4922,大正区,68096,33338,34758,30149,2012-05-01
4923,天王寺区,72017,33381,38636,35976,2012-05-01
4924,中央区,82136,38444,43692,51903,2012-05-01
4925,城東区,165034,78994,86040,75992,2012-06-01
4926,東成区,80608,38577,42031,39301,2012-06-01
4927,生野区,132454,63545,68909,63230,2012-06-01
4928,旭区,91999,43990,48009,43701,2012-06-01
4929,鶴見区,111454,53363,58091,45614,2012-06-01
4930,東淀川区,177232,87229,90003,92651,2012-06-01
4931,住之江区,125817,60356,65461,56671,2012-06-01
4932,住吉区,154995,72740,82255,73313,2012-06-01
4933,東住吉区,128990,61030,67960,59192,2012-06-01
4934,平野区,199219,94570,104649,87377,2012-06-01
4935,阿倍野区,106498,49022,57476,49720,2012-06-01
4936,西成区,118685,69584,49101,73174,2012-06-01
4937,淀川区,172792,85514,87278,91897,2012-06-01
4938,浪速区,64046,32506,31540,43827,2012-06-01
4939,大阪市,2673340,1296197,1377143,1331179,2012-06-01
4940,北区,114176,54822,59354,67995,2012-06-01
4941,都島区,104065,50155,53910,50778,2012-06-01
4942,福島区,69438,32806,36632,35640,2012-06-01
4943,此花区,66377,32319,34058,29948,2012-06-01
4944,西淀川区,97150,48039,49111,43453,2012-06-01
4945,西区,85955,40619,45336,48846,2012-06-01
4946,港区,83827,41081,42746,40562,2012-06-01
4947,大正区,68024,33305,34719,30135,2012-06-01
4948,天王寺区,72133,33444,38689,36069,2012-06-01
4949,中央区,82372,38587,43785,52093,2012-06-01
4950,生野区,132399,63507,68892,63249,2012-07-01
4951,旭区,91982,43987,47995,43709,2012-07-01
4952,城東区,165015,78968,86047,75994,2012-07-01
4953,鶴見区,111399,53349,58050,45634,2012-07-01
4954,阿倍野区,106511,49047,57464,49725,2012-07-01
4955,住吉区,154982,72731,82251,73271,2012-07-01
4956,東住吉区,128851,60952,67899,59158,2012-07-01
4957,平野区,199167,94565,104602,87406,2012-07-01
4958,西成区,118520,69480,49040,73117,2012-07-01
4959,東成区,80590,38578,42012,39274,2012-07-01
4960,住之江区,125777,60349,65428,56690,2012-07-01
4961,東淀川区,177222,87239,89983,92666,2012-07-01
4962,淀川区,172815,85521,87294,91904,2012-07-01
4963,西淀川区,97068,48006,49062,43426,2012-07-01
4964,北区,114224,54804,59420,68045,2012-07-01
4965,都島区,104117,50194,53923,50818,2012-07-01
4966,福島区,69506,32841,36665,35673,2012-07-01
4967,此花区,66456,32371,34085,29997,2012-07-01
4968,中央区,82575,38647,43928,52196,2012-07-01
4969,大阪市,2673229,1296105,1377124,1331492,2012-07-01
4970,港区,83733,41017,42716,40533,2012-07-01
4971,大正区,67964,33272,34692,30118,2012-07-01
4972,天王寺区,72188,33486,38702,36102,2012-07-01
4973,浪速区,64127,32532,31595,43883,2012-07-01
4974,西区,86041,40662,45379,48904,2012-07-01
4975,生野区,132366,63466,68900,63255,2012-08-01
4976,旭区,92027,44016,48011,43725,2012-08-01
4977,城東区,164941,78926,86015,75957,2012-08-01
4978,鶴見区,111332,53326,58006,45614,2012-08-01
4979,阿倍野区,106481,49037,57444,49706,2012-08-01
4980,住吉区,154882,72653,82229,73176,2012-08-01
4981,東住吉区,128856,60972,67884,59136,2012-08-01
4982,平野区,199148,94555,104593,87462,2012-08-01
4983,西成区,118442,69397,49045,73106,2012-08-01
4984,東成区,80548,38578,41970,39277,2012-08-01
4985,住之江区,125868,60400,65468,56758,2012-08-01
4986,東淀川区,177183,87218,89965,92637,2012-08-01
4987,淀川区,172848,85571,87277,91958,2012-08-01
4988,西淀川区,97043,47981,49062,43442,2012-08-01
4989,北区,114494,55015,59479,68238,2012-08-01
4990,都島区,104156,50197,53959,50843,2012-08-01
4991,福島区,69664,32895,36769,35761,2012-08-01
4992,此花区,66449,32369,34080,30014,2012-08-01
4993,中央区,82772,38721,44051,52292,2012-08-01
4994,大阪市,2673569,1296293,1377276,1331918,2012-08-01
4995,港区,83624,40960,42664,40486,2012-08-01
4996,大正区,67911,33257,34654,30098,2012-08-01
4997,天王寺区,72232,33526,38706,36112,2012-08-01
4998,浪速区,64218,32576,31642,43944,2012-08-01
4999,西区,86084,40681,45403,48921,2012-08-01
5000,生野区,132327,63490,68837,63255,2012-09-01
5001,旭区,92056,44023,48033,43757,2012-09-01
5002,城東区,164910,78927,85983,75913,2012-09-01
5003,鶴見区,111292,53296,57996,45598,2012-09-01
5004,阿倍野区,106569,49097,57472,49761,2012-09-01
5005,住吉区,154961,72691,82270,73146,2012-09-01
5006,東住吉区,128822,60970,67852,59076,2012-09-01
5007,平野区,199095,94515,104580,87489,2012-09-01
5008,西成区,118321,69315,49006,73073,2012-09-01
5009,東成区,80603,38595,42008,39311,2012-09-01
5010,住之江区,125859,60415,65444,56793,2012-09-01
5011,東淀川区,177209,87234,89975,92648,2012-09-01
5012,淀川区,172906,85640,87266,91960,2012-09-01
5013,西淀川区,97025,47961,49064,43412,2012-09-01
5014,北区,114618,55083,59535,68306,2012-09-01
5015,都島区,104124,50194,53930,50785,2012-09-01
5016,福島区,69815,32969,36846,35824,2012-09-01
5017,此花区,66508,32416,34092,30070,2012-09-01
5018,中央区,82996,38842,44154,52423,2012-09-01
5019,大阪市,2674115,1296818,1377297,1332218,2012-09-01
5020,港区,83492,40915,42577,40432,2012-09-01
5021,大正区,67793,33223,34570,30060,2012-09-01
5022,天王寺区,72257,33570,38687,36140,2012-09-01
5023,浪速区,64287,32649,31638,44014,2012-09-01
5024,西区,86270,40788,45482,48972,2012-09-01
5025,東成区,80652,38625,42027,39335,2012-10-01
5026,生野区,132316,63467,68849,63220,2012-10-01
5027,旭区,92046,44015,48031,43755,2012-10-01
5028,城東区,164892,78931,85961,75885,2012-10-01
5029,鶴見区,111289,53306,57983,45602,2012-10-01
5030,住之江区,125839,60410,65429,56819,2012-10-01
5031,住吉区,155010,72683,82327,73136,2012-10-01
5032,東住吉区,128738,60953,67785,59011,2012-10-01
5033,平野区,199036,94494,104542,87481,2012-10-01
5034,東淀川区,177201,87235,89966,92582,2012-10-01
5035,阿倍野区,106587,49105,57482,49779,2012-10-01
5036,淀川区,172945,85650,87295,91957,2012-10-01
5037,西成区,118197,69228,48969,73007,2012-10-01
5038,浪速区,64449,32718,31731,44060,2012-10-01
5039,大阪市,2674154,1296740,1377414,1332002,2012-10-01
5040,北区,114629,55087,59542,68296,2012-10-01
5041,都島区,104077,50167,53910,50780,2012-10-01
5042,福島区,69804,32952,36852,35823,2012-10-01
5043,此花区,66540,32432,34108,30093,2012-10-01
5044,西淀川区,97039,47972,49067,43389,2012-10-01
5045,西区,86302,40768,45534,48940,2012-10-01
5046,港区,83487,40900,42587,40410,2012-10-01
5047,大正区,67712,33179,34533,30020,2012-10-01
5048,天王寺区,72266,33575,38691,36154,2012-10-01
5049,中央区,83101,38888,44213,52468,2012-10-01
5050,生野区,132309,63483,68826,63201,2012-11-01
5051,旭区,92069,44050,48019,43753,2012-11-01
5052,城東区,164845,78897,85948,75868,2012-11-01
5053,鶴見区,111421,53353,58068,45658,2012-11-01
5054,阿倍野区,106536,49085,57451,49752,2012-11-01
5055,住吉区,154989,72672,82317,73044,2012-11-01
5056,東住吉区,128661,60938,67723,58992,2012-11-01
5057,平野区,199187,94548,104639,87579,2012-11-01
5058,西成区,118031,69139,48892,72949,2012-11-01
5059,東成区,80675,38643,42032,39348,2012-11-01
5060,住之江区,125757,60363,65394,56804,2012-11-01
5061,東淀川区,177226,87266,89960,92534,2012-11-01
5062,淀川区,173123,85764,87359,92020,2012-11-01
5063,西淀川区,96945,47906,49039,43394,2012-11-01
5064,北区,114795,55198,59597,68382,2012-11-01
5065,都島区,104205,50262,53943,50824,2012-11-01
5066,福島区,69938,33018,36920,35886,2012-11-01
5067,此花区,66503,32410,34093,30051,2012-11-01
5068,中央区,83339,39020,44319,52546,2012-11-01
5069,大阪市,2675198,1297321,1377877,1332260,2012-11-01
5070,港区,83442,40881,42561,40379,2012-11-01
5071,大正区,67623,33129,34494,29969,2012-11-01
5072,天王寺区,72385,33615,38770,36165,2012-11-01
5073,浪速区,64775,32864,31911,44180,2012-11-01
5074,西区,86419,40817,45602,48982,2012-11-01
5075,東成区,80694,38661,42033,39356,2012-12-01
5076,生野区,132193,63440,68753,63190,2012-12-01
5077,旭区,92067,44045,48022,43750,2012-12-01
5078,城東区,164703,78808,85895,75813,2012-12-01
5079,鶴見区,111438,53345,58093,45652,2012-12-01
5080,住之江区,125751,60365,65386,56822,2012-12-01
5081,住吉区,154803,72602,82201,72959,2012-12-01
5082,東住吉区,128493,60825,67668,58903,2012-12-01
5083,平野区,199147,94525,104622,87571,2012-12-01
5084,東淀川区,177152,87238,89914,92475,2012-12-01
5085,阿倍野区,106505,49047,57458,49712,2012-12-01
5086,淀川区,173258,85804,87454,92077,2012-12-01
5087,西成区,117875,69030,48845,72847,2012-12-01
5088,浪速区,64859,32910,31949,44272,2012-12-01
5089,大阪市,2675093,1297153,1377940,1332148,2012-12-01
5090,北区,114837,55210,59627,68369,2012-12-01
5091,都島区,104232,50299,53933,50835,2012-12-01
5092,福島区,70264,33136,37128,36034,2012-12-01
5093,此花区,66480,32404,34076,30037,2012-12-01
5094,西淀川区,96901,47850,49051,43349,2012-12-01
5095,西区,86454,40847,45607,48986,2012-12-01
5096,港区,83406,40874,42532,40343,2012-12-01
5097,大正区,67539,33075,34464,29945,2012-12-01
5098,天王寺区,72598,33718,38880,36253,2012-12-01
5099,中央区,83444,39095,44349,52598,2012-12-01
5100,東成区,80687,38666,42021,39337,2013-01-01
5101,生野区,132068,63389,68679,63147,2013-01-01
5102,旭区,92001,43988,48013,43704,2013-01-01
5103,城東区,164634,78760,85874,75776,2013-01-01
5104,鶴見区,111485,53384,58101,45664,2013-01-01
5105,住之江区,125761,60367,65394,56872,2013-01-01
5106,住吉区,154792,72580,82212,72923,2013-01-01
5107,東住吉区,128375,60771,67604,58802,2013-01-01
5108,平野区,199048,94447,104601,87577,2013-01-01
5109,東淀川区,177056,87162,89894,92395,2013-01-01
5110,阿倍野区,106504,49058,57446,49688,2013-01-01
5111,淀川区,173422,85877,87545,92134,2013-01-01
5112,西成区,117738,68961,48777,72770,2013-01-01
5113,浪速区,64945,32975,31970,44371,2013-01-01
5114,大阪市,2675108,1297146,1377962,1332018,2013-01-01
5115,北区,114949,55263,59686,68459,2013-01-01
5116,都島区,104308,50341,53967,50864,2013-01-01
5117,福島区,70365,33175,37190,36083,2013-01-01
5118,此花区,66572,32448,34124,30064,2013-01-01
5119,西淀川区,96849,47821,49028,43330,2013-01-01
5120,西区,86510,40883,45627,48980,2013-01-01
5121,港区,83289,40822,42467,40294,2013-01-01
5122,大正区,67429,33013,34416,29851,2013-01-01
5123,天王寺区,72780,33826,38954,36289,2013-01-01
5124,中央区,83541,39169,44372,52644,2013-01-01
5125,東成区,80644,38649,41995,39328,2013-02-01
5126,生野区,132042,63363,68679,63117,2013-02-01
5127,旭区,91944,43961,47983,43671,2013-02-01
5128,城東区,164531,78701,85830,75723,2013-02-01
5129,鶴見区,111518,53391,58127,45669,2013-02-01
5130,住之江区,125650,60307,65343,56849,2013-02-01
5131,住吉区,154784,72576,82208,72800,2013-02-01
5132,東住吉区,128231,60706,67525,58682,2013-02-01
5133,平野区,198939,94377,104562,87547,2013-02-01
5134,東淀川区,176990,87121,89869,92315,2013-02-01
5135,阿倍野区,106456,49029,57427,49664,2013-02-01
5136,西成区,117626,68879,48747,72680,2013-02-01
5137,淀川区,173439,85885,87554,92120,2013-02-01
5138,浪速区,65085,33060,32025,44449,2013-02-01
5139,西淀川区,96788,47779,49009,43290,2013-02-01
5140,大阪市,2674661,1296833,1377828,1331420,2013-02-01
5141,北区,115097,55320,59777,68471,2013-02-01
5142,福島区,70373,33178,37195,36068,2013-02-01
5143,此花区,66573,32454,34119,30065,2013-02-01
5144,都島区,104290,50318,53972,50799,2013-02-01
5145,西区,86588,40949,45639,48985,2013-02-01
5146,港区,83237,40802,42435,40256,2013-02-01
5147,大正区,67397,32970,34427,29832,2013-02-01
5148,天王寺区,72783,33851,38932,36310,2013-02-01
5149,中央区,83656,39207,44449,52730,2013-02-01
5150,鶴見区,111451,53373,58078,45661,2013-03-01
5151,生野区,131972,63341,68631,63100,2013-03-01
5152,旭区,91944,43970,47974,43679,2013-03-01
5153,城東区,164558,78685,85873,75699,2013-03-01
5154,阿倍野区,106363,48998,57365,49601,2013-03-01
5155,東成区,80569,38597,41972,39297,2013-03-01
5156,住吉区,154683,72518,82165,72745,2013-03-01
5157,東住吉区,128134,60636,67498,58637,2013-03-01
5158,平野区,198940,94377,104563,87586,2013-03-01
5159,西成区,117538,68797,48741,72586,2013-03-01
5160,住之江区,125603,60279,65324,56866,2013-03-01
5161,東淀川区,176854,87048,89806,92203,2013-03-01
5162,西区,86677,41004,45673,49003,2013-03-01
5163,西淀川区,96631,47663,48968,43196,2013-03-01
5164,北区,115162,55329,59833,68472,2013-03-01
5165,都島区,104169,50262,53907,50745,2013-03-01
5166,福島区,70413,33202,37211,36080,2013-03-01
5167,此花区,66574,32461,34113,30072,2013-03-01
5168,中央区,83703,39222,44481,52727,2013-03-01
5169,大阪市,2673891,1296296,1377595,1330970,2013-03-01
5170,港区,83206,40789,42417,40221,2013-03-01
5171,大正区,67336,32913,34423,29833,2013-03-01
5172,天王寺区,72869,33890,38979,36354,2013-03-01
5173,浪速区,65093,33064,32029,44511,2013-03-01
5174,淀川区,173449,85878,87571,92096,2013-03-01
5175,生野区,131902,63331,68571,63203,2013-04-01
5176,旭区,91788,43881,47907,43643,2013-04-01
5177,城東区,164359,78508,85851,75748,2013-04-01
5178,鶴見区,111197,53230,57967,45663,2013-04-01
5179,阿倍野区,106594,49061,57533,49723,2013-04-01
5180,住吉区,154459,72323,82136,72778,2013-04-01
5181,東住吉区,127984,60481,67503,58620,2013-04-01
5182,平野区,198650,94197,104453,87643,2013-04-01
5183,西成区,117342,68648,48694,72489,2013-04-01
5184,東成区,80558,38566,41992,39359,2013-04-01
5185,住之江区,125355,60166,65189,56866,2013-04-01
5186,東淀川区,176707,86942,89765,92397,2013-04-01
5187,淀川区,173633,85843,87790,92374,2013-04-01
5188,西淀川区,96544,47614,48930,43195,2013-04-01
5189,北区,115659,55542,60117,68819,2013-04-01
5190,都島区,104159,50194,53965,50864,2013-04-01
5191,福島区,70559,33287,37272,36230,2013-04-01
5192,此花区,66481,32438,34043,30096,2013-04-01
5193,中央区,84460,39555,44905,53225,2013-04-01
5194,大阪市,2674028,1295496,1378532,1333495,2013-04-01
5195,港区,83086,40733,42353,40282,2013-04-01
5196,大正区,67208,32845,34363,29789,2013-04-01
5197,天王寺区,73058,33864,39194,36542,2013-04-01
5198,浪速区,65324,33169,32155,44727,2013-04-01
5199,西区,86962,41078,45884,49220,2013-04-01
5200,東成区,80583,38563,42020,39445,2013-05-01
5201,生野区,131870,63313,68557,63304,2013-05-01
5202,旭区,91857,43960,47897,43677,2013-05-01
5203,城東区,164510,78574,85936,75877,2013-05-01
5204,鶴見区,111366,53310,58056,45768,2013-05-01
5205,住之江区,125343,60155,65188,56910,2013-05-01
5206,住吉区,154607,72407,82200,72862,2013-05-01
5207,東住吉区,127961,60502,67459,58614,2013-05-01
5208,平野区,198596,94157,104439,87727,2013-05-01
5209,東淀川区,176920,87047,89873,92620,2013-05-01
5210,阿倍野区,106808,49167,57641,49899,2013-05-01
5211,淀川区,174050,86078,87972,92710,2013-05-01
5212,西成区,117244,68589,48655,72489,2013-05-01
5213,浪速区,65734,33410,32324,45029,2013-05-01
5214,大阪市,2678065,1297740,1380325,1337050,2013-05-01
5215,北区,116242,55929,60313,69262,2013-05-01
5216,都島区,104309,50259,54050,51003,2013-05-01
5217,福島区,70890,33470,37420,36455,2013-05-01
5218,此花区,66522,32468,34054,30145,2013-05-01
5219,西淀川区,96589,47654,48935,43242,2013-05-01
5220,西区,87237,41193,46044,49406,2013-05-01
5221,港区,83085,40745,42340,40332,2013-05-01
5222,大正区,67128,32826,34302,29797,2013-05-01
5223,天王寺区,73329,34021,39308,36703,2013-05-01
5224,中央区,85285,39943,45342,53774,2013-05-01
5225,東成区,80623,38567,42056,39447,2013-06-01
5226,生野区,131804,63283,68521,63329,2013-06-01
5227,旭区,91903,43966,47937,43736,2013-06-01
5228,城東区,164411,78528,85883,75862,2013-06-01
5229,鶴見区,111370,53323,58047,45790,2013-06-01
5230,住之江区,125315,60151,65164,56941,2013-06-01
5231,住吉区,154635,72435,82200,72757,2013-06-01
5232,東住吉区,127866,60460,67406,58528,2013-06-01
5233,平野区,198581,94155,104426,87815,2013-06-01
5234,東淀川区,176900,87041,89859,92639,2013-06-01
5235,阿倍野区,106849,49170,57679,49913,2013-06-01
5236,淀川区,174261,86192,88069,92837,2013-06-01
5237,西成区,117122,68481,48641,72461,2013-06-01
5238,浪速区,65847,33480,32367,45191,2013-06-01
5239,大阪市,2678725,1298040,1380685,1338002,2013-06-01
5240,北区,116440,56033,60407,69404,2013-06-01
5241,都島区,104378,50308,54070,51041,2013-06-01
5242,福島区,71064,33571,37493,36577,2013-06-01
5243,此花区,66510,32456,34054,30165,2013-06-01
5244,西淀川区,96555,47627,48928,43221,2013-06-01
5245,西区,87350,41240,46110,49520,2013-06-01
5246,港区,83091,40747,42344,40354,2013-06-01
5247,大正区,67046,32780,34266,29781,2013-06-01
5248,天王寺区,73336,34023,39313,36696,2013-06-01
5249,中央区,85468,40023,45445,53997,2013-06-01
5250,東成区,80649,38579,42070,39491,2013-07-01
5251,生野区,131841,63332,68509,63365,2013-07-01
5252,旭区,91882,43923,47959,43734,2013-07-01
5253,城東区,164400,78500,85900,75835,2013-07-01
5254,鶴見区,111341,53320,58021,45778,2013-07-01
5255,住之江区,125272,60130,65142,56950,2013-07-01
5256,住吉区,154562,72387,82175,72696,2013-07-01
5257,東住吉区,127759,60439,67320,58485,2013-07-01
5258,平野区,198571,94141,104430,87890,2013-07-01
5259,東淀川区,176840,87026,89814,92602,2013-07-01
5260,阿倍野区,106709,49096,57613,49836,2013-07-01
5261,西成区,116926,68322,48604,72368,2013-07-01
5262,淀川区,174287,86187,88100,92838,2013-07-01
5263,浪速区,65883,33492,32391,45256,2013-07-01
5264,西淀川区,96577,47648,48929,43213,2013-07-01
5265,大阪市,2678467,1297816,1380651,1338177,2013-07-01
5266,北区,116472,56044,60428,69420,2013-07-01
5267,福島区,71157,33623,37534,36624,2013-07-01
5268,此花区,66517,32472,34045,30198,2013-07-01
5269,都島区,104361,50309,54052,51062,2013-07-01
5270,西区,87387,41246,46141,49525,2013-07-01
5271,港区,83055,40718,42337,40365,2013-07-01
5272,大正区,67012,32763,34249,29775,2013-07-01
5273,天王寺区,73372,34048,39324,36721,2013-07-01
5274,中央区,85635,40071,45564,54150,2013-07-01
5275,城東区,164397,78478,85919,75816,2013-08-01
5276,東成区,80612,38559,42053,39474,2013-08-01
5277,生野区,131873,63381,68492,63414,2013-08-01
5278,旭区,91903,43933,47970,43719,2013-08-01
5279,鶴見区,111332,53308,58024,45801,2013-08-01
5280,東淀川区,176743,86978,89765,92567,2013-08-01
5281,住之江区,125111,60083,65028,56932,2013-08-01
5282,住吉区,154757,72460,82297,72666,2013-08-01
5283,東住吉区,127692,60416,67276,58467,2013-08-01
5284,平野区,198533,94119,104414,87935,2013-08-01
5285,阿倍野区,106753,49123,57630,49842,2013-08-01
5286,淀川区,174315,86238,88077,92894,2013-08-01
5287,西成区,116772,68235,48537,72319,2013-08-01
5288,浪速区,66057,33584,32473,45363,2013-08-01
5289,大阪市,2678858,1298095,1380763,1338715,2013-08-01
5290,北区,116661,56149,60512,69563,2013-08-01
5291,都島区,104375,50312,54063,51078,2013-08-01
5292,福島区,71199,33647,37552,36653,2013-08-01
5293,此花区,66614,32523,34091,30247,2013-08-01
5294,西淀川区,96558,47648,48910,43214,2013-08-01
5295,西区,87494,41306,46188,49571,2013-08-01
5296,港区,82931,40652,42279,40341,2013-08-01
5297,大正区,66929,32722,34207,29766,2013-08-01
5298,天王寺区,73357,34056,39301,36741,2013-08-01
5299,中央区,85890,40185,45705,54332,2013-08-01
5300,東成区,80545,38510,42035,39425,2013-09-01
5301,生野区,131679,63266,68413,63330,2013-09-01
5302,旭区,91853,43902,47951,43720,2013-09-01
5303,城東区,164343,78482,85861,75764,2013-09-01
5304,鶴見区,111276,53274,58002,45784,2013-09-01
5305,住之江区,125080,60063,65017,56911,2013-09-01
5306,東淀川区,176702,86969,89733,92525,2013-09-01
5307,住吉区,154714,72453,82261,72626,2013-09-01
5308,東住吉区,127724,60431,67293,58482,2013-09-01
5309,平野区,198402,94062,104340,87934,2013-09-01
5310,阿倍野区,106700,49102,57598,49842,2013-09-01
5311,淀川区,174354,86262,88092,92934,2013-09-01
5312,西成区,116559,68082,48477,72213,2013-09-01
5313,浪速区,66156,33654,32502,45467,2013-09-01
5314,大阪市,2678840,1298101,1380739,1339061,2013-09-01
5315,北区,117420,56515,60905,69983,2013-09-01
5316,都島区,104353,50313,54040,51072,2013-09-01
5317,福島区,71235,33660,37575,36709,2013-09-01
5318,此花区,66649,32543,34106,30272,2013-09-01
5319,西淀川区,96412,47591,48821,43175,2013-09-01
5320,西区,87522,41327,46195,49568,2013-09-01
5321,港区,82848,40597,42251,40318,2013-09-01
5322,大正区,66833,32678,34155,29751,2013-09-01
5323,天王寺区,73445,34121,39324,36816,2013-09-01
5324,中央区,86036,40244,45792,54440,2013-09-01
5325,東成区,80538,38499,42039,39450,2013-10-01
5326,生野区,131506,63200,68306,63285,2013-10-01
5327,旭区,91826,43869,47957,43699,2013-10-01
5328,城東区,164200,78398,85802,75701,2013-10-01
5329,鶴見区,111286,53285,58001,45772,2013-10-01
5330,住之江区,125029,60028,65001,56920,2013-10-01
5331,住吉区,154696,72453,82243,72555,2013-10-01
5332,東住吉区,127740,60456,67284,58463,2013-10-01
5333,平野区,198384,94032,104352,87954,2013-10-01
5334,東淀川区,176657,86975,89682,92472,2013-10-01
5335,阿倍野区,106754,49123,57631,49889,2013-10-01
5336,西成区,116327,67941,48386,72141,2013-10-01
5337,淀川区,174401,86285,88116,92922,2013-10-01
5338,浪速区,66273,33706,32567,45508,2013-10-01
5339,西淀川区,96417,47576,48841,43140,2013-10-01
5340,大阪市,2678663,1297931,1380732,1338910,2013-10-01
5341,北区,117502,56534,60968,69988,2013-10-01
5342,都島区,104358,50313,54045,51068,2013-10-01
5343,此花区,66609,32506,34103,30269,2013-10-01
5344,福島区,71259,33670,37589,36718,2013-10-01
5345,西区,87645,41378,46267,49623,2013-10-01
5346,港区,82785,40552,42233,40283,2013-10-01
5347,大正区,66769,32634,34135,29711,2013-10-01
5348,天王寺区,73561,34180,39381,36850,2013-10-01
5349,中央区,86141,40338,45803,54529,2013-10-01
5350,西成区,116203,67831,48372,72079,2013-11-01
5351,東成区,80543,38482,42061,39442,2013-11-01
5352,生野区,131531,63227,68304,63287,2013-11-01
5353,旭区,91864,43887,47977,43724,2013-11-01
5354,城東区,164172,78350,85822,75681,2013-11-01
5355,住之江区,125002,59990,65012,56933,2013-11-01
5356,阿倍野区,106862,49200,57662,49939,2013-11-01
5357,住吉区,154723,72489,82234,72455,2013-11-01
5358,東住吉区,127682,60450,67232,58435,2013-11-01
5359,平野区,198360,94017,104343,88014,2013-11-01
5360,鶴見区,111305,53295,58010,45786,2013-11-01
5361,東淀川区,176608,86982,89626,92376,2013-11-01
5362,淀川区,174460,86342,88118,92888,2013-11-01
5363,浪速区,66257,33705,32552,45399,2013-11-01
5364,大阪市,2679337,1298363,1380974,1338936,2013-11-01
5365,北区,117603,56600,61003,70028,2013-11-01
5366,都島区,104417,50384,54033,51083,2013-11-01
5367,福島区,71344,33726,37618,36764,2013-11-01
5368,此花区,66674,32533,34141,30287,2013-11-01
5369,西淀川区,96379,47555,48824,43121,2013-11-01
5370,西区,87903,41498,46405,49725,2013-11-01
5371,港区,82671,40508,42163,40245,2013-11-01
5372,大正区,66667,32582,34085,29668,2013-11-01
5373,天王寺区,73692,34255,39437,36909,2013-11-01
5374,中央区,86415,40475,45940,54668,2013-11-01
5375,東成区,80565,38500,42065,39426,2013-12-01
5376,生野区,131397,63161,68236,63274,2013-12-01
5377,旭区,91845,43912,47933,43697,2013-12-01
5378,城東区,164090,78309,85781,75611,2013-12-01
5379,鶴見区,111305,53296,58009,45794,2013-12-01
5380,住之江区,124920,59956,64964,56912,2013-12-01
5381,住吉区,154635,72423,82212,72354,2013-12-01
5382,東住吉区,127569,60363,67206,58422,2013-12-01
5383,平野区,198293,93990,104303,88044,2013-12-01
5384,東淀川区,176585,86975,89610,92355,2013-12-01
5385,阿倍野区,107025,49320,57705,50013,2013-12-01
5386,淀川区,174363,86329,88034,92812,2013-12-01
5387,西成区,115927,67661,48266,71917,2013-12-01
5388,浪速区,66254,33684,32570,45428,2013-12-01
5389,大阪市,2678873,1298122,1380751,1338613,2013-12-01
5390,北区,117878,56730,61148,70110,2013-12-01
5391,都島区,104415,50372,54043,51057,2013-12-01
5392,福島区,71376,33718,37658,36774,2013-12-01
5393,此花区,66691,32560,34131,30304,2013-12-01
5394,西淀川区,96260,47492,48768,43044,2013-12-01
5395,西区,88017,41541,46476,49765,2013-12-01
5396,港区,82578,40458,42120,40204,2013-12-01
5397,大正区,66651,32571,34080,29653,2013-12-01
5398,天王寺区,73763,34308,39455,36909,2013-12-01
5399,中央区,86471,40493,45978,54734,2013-12-01
5400,東成区,80559,38481,42078,39444,2014-01-01
5401,生野区,131238,63086,68152,63226,2014-01-01
5402,旭区,91850,43904,47946,43717,2014-01-01
5403,城東区,163946,78246,85700,75505,2014-01-01
5404,鶴見区,111327,53315,58012,45808,2014-01-01
5405,住之江区,124828,59924,64904,56897,2014-01-01
5406,住吉区,154468,72372,82096,72283,2014-01-01
5407,東住吉区,127500,60320,67180,58361,2014-01-01
5408,平野区,198150,93918,104232,88039,2014-01-01
5409,東淀川区,176385,86853,89532,92230,2014-01-01
5410,阿倍野区,107281,49451,57830,50116,2014-01-01
5411,西成区,115713,67514,48199,71781,2014-01-01
5412,淀川区,174288,86264,88024,92745,2014-01-01
5413,浪速区,66291,33687,32604,45458,2014-01-01
5414,西淀川区,96223,47476,48747,43023,2014-01-01
5415,大阪市,2678238,1297669,1380569,1338136,2014-01-01
5416,北区,118136,56892,61244,70245,2014-01-01
5417,福島区,71401,33730,37671,36772,2014-01-01
5418,此花区,66686,32556,34130,30291,2014-01-01
5419,都島区,104393,50347,54046,51006,2014-01-01
5420,西区,88052,41562,46490,49776,2014-01-01
5421,港区,82489,40408,42081,40150,2014-01-01
5422,大正区,66629,32542,34087,29651,2014-01-01
5423,天王寺区,73877,34357,39520,36979,2014-01-01
5424,中央区,86528,40464,46064,54633,2014-01-01
5425,鶴見区,111386,53349,58037,45805,2014-02-01
5426,生野区,131089,63027,68062,63180,2014-02-01
5427,旭区,91811,43889,47922,43670,2014-02-01
5428,城東区,163783,78158,85625,75424,2014-02-01
5429,阿倍野区,107248,49441,57807,50062,2014-02-01
5430,東成区,80494,38434,42060,39432,2014-02-01
5431,住吉区,154307,72304,82003,72177,2014-02-01
5432,東住吉区,127403,60286,67117,58296,2014-02-01
5433,平野区,197991,93832,104159,87998,2014-02-01
5434,西成区,115482,67363,48119,71542,2014-02-01
5435,住之江区,124685,59859,64826,56895,2014-02-01
5436,東淀川区,176285,86793,89492,92157,2014-02-01
5437,淀川区,174213,86192,88021,92664,2014-02-01
5438,西淀川区,96147,47418,48729,42992,2014-02-01
5439,北区,118134,56881,61253,70245,2014-02-01
5440,都島区,104354,50313,54041,50975,2014-02-01
5441,福島区,71473,33789,37684,36777,2014-02-01
5442,此花区,66701,32566,34135,30286,2014-02-01
5443,中央区,86576,40478,46098,54670,2014-02-01
5444,大阪市,2676778,1296856,1379922,1337160,2014-02-01
5445,港区,82351,40330,42021,40099,2014-02-01
5446,大正区,66583,32507,34076,29585,2014-02-01
5447,天王寺区,73887,34369,39518,36983,2014-02-01
5448,浪速区,66368,33735,32633,45497,2014-02-01
5449,西区,88027,41543,46484,49749,2014-02-01
5450,生野区,130928,62920,68008,63124,2014-03-01
5451,旭区,91770,43876,47894,43579,2014-03-01
5452,城東区,163719,78100,85619,75413,2014-03-01
5453,鶴見区,111413,53353,58060,45833,2014-03-01
5454,阿倍野区,107156,49408,57748,50002,2014-03-01
5455,住吉区,154077,72186,81891,72045,2014-03-01
5456,東住吉区,127289,60197,67092,58269,2014-03-01
5457,平野区,197814,93759,104055,87967,2014-03-01
5458,西成区,115247,67189,48058,71424,2014-03-01
5459,東成区,80479,38427,42052,39447,2014-03-01
5460,住之江区,124513,59755,64758,56880,2014-03-01
5461,東淀川区,176146,86710,89436,92083,2014-03-01
5462,淀川区,174153,86140,88013,92669,2014-03-01
5463,西淀川区,96016,47337,48679,42941,2014-03-01
5464,北区,118230,56932,61298,70330,2014-03-01
5465,都島区,104264,50249,54015,50937,2014-03-01
5466,福島区,71455,33789,37666,36783,2014-03-01
5467,此花区,66691,32570,34121,30323,2014-03-01
5468,中央区,86718,40574,46144,54805,2014-03-01
5469,大阪市,2675373,1296022,1379351,1336882,2014-03-01
5470,港区,82301,40315,41986,40081,2014-03-01
5471,大正区,66510,32483,34027,29578,2014-03-01
5472,天王寺区,73902,34379,39523,36979,2014-03-01
5473,浪速区,66499,33832,32667,45637,2014-03-01
5474,西区,88083,41542,46541,49753,2014-03-01
5475,東成区,80374,38398,41976,39504,2014-04-01
5476,生野区,130724,62815,67909,63228,2014-04-01
5477,旭区,91606,43765,47841,43627,2014-04-01
5478,城東区,163599,77974,85625,75585,2014-04-01
5479,鶴見区,111181,53215,57966,45886,2014-04-01
5480,住之江区,124216,59593,64623,56882,2014-04-01
5481,住吉区,153795,71954,81841,72012,2014-04-01
5482,東住吉区,127178,60084,67094,58316,2014-04-01
5483,平野区,197688,93649,104039,88196,2014-04-01
5484,東淀川区,175854,86536,89318,92292,2014-04-01
5485,阿倍野区,107144,49305,57839,49974,2014-04-01
5486,淀川区,174597,86258,88339,93160,2014-04-01
5487,西成区,114955,67005,47950,71346,2014-04-01
5488,浪速区,66623,33863,32760,45869,2014-04-01
5489,大阪市,2674629,1294701,1379928,1340145,2014-04-01
5490,北区,118644,57061,61583,70768,2014-04-01
5491,都島区,104409,50266,54143,51110,2014-04-01
5492,福島区,71470,33729,37741,36871,2014-04-01
5493,此花区,66634,32505,34129,30361,2014-04-01
5494,西淀川区,95904,47292,48612,42994,2014-04-01
5495,西区,88485,41711,46774,50113,2014-04-01
5496,港区,82212,40264,41948,40187,2014-04-01
5497,大正区,66278,32363,33915,29544,2014-04-01
5498,天王寺区,73855,34344,39511,37045,2014-04-01
5499,中央区,87204,40752,46452,55275,2014-04-01
5500,東成区,80414,38417,41997,39578,2014-05-01
5501,生野区,130868,62948,67920,63288,2014-05-01
5502,旭区,91626,43786,47840,43648,2014-05-01
5503,城東区,164110,78239,85871,75856,2014-05-01
5504,鶴見区,111105,53169,57936,45933,2014-05-01
5505,住之江区,124206,59591,64615,56925,2014-05-01
5506,住吉区,153860,71990,81870,72060,2014-05-01
5507,東住吉区,127105,60061,67044,58300,2014-05-01
5508,平野区,197772,93709,104063,88283,2014-05-01
5509,東淀川区,176042,86601,89441,92485,2014-05-01
5510,阿倍野区,107395,49428,57967,50145,2014-05-01
5511,淀川区,174855,86430,88425,93367,2014-05-01
5512,西成区,114960,66987,47973,71303,2014-05-01
5513,浪速区,66835,33987,32848,46025,2014-05-01
5514,大阪市,2678793,1296895,1381898,1343377,2014-05-01
5515,北区,119667,57571,62096,71445,2014-05-01
5516,都島区,104593,50378,54215,51243,2014-05-01
5517,福島区,71502,33736,37766,36956,2014-05-01
5518,此花区,66594,32488,34106,30387,2014-05-01
5519,西淀川区,95876,47321,48555,43026,2014-05-01
5520,西区,88850,41919,46931,50342,2014-05-01
5521,港区,82269,40257,42012,40282,2014-05-01
5522,大正区,66247,32344,33903,29567,2014-05-01
5523,天王寺区,74154,34481,39673,37214,2014-05-01
5524,中央区,87888,41057,46831,55719,2014-05-01
5525,東成区,80352,38387,41965,39513,2014-06-01
5526,生野区,130715,62907,67808,63298,2014-06-01
5527,旭区,91656,43822,47834,43677,2014-06-01
5528,城東区,164200,78268,85932,75927,2014-06-01
5529,鶴見区,111130,53191,57939,45942,2014-06-01
5530,住之江区,124096,59533,64563,56890,2014-06-01
5531,住吉区,153916,72068,81848,72039,2014-06-01
5532,東住吉区,127084,60096,66988,58278,2014-06-01
5533,平野区,197708,93700,104008,88322,2014-06-01
5534,東淀川区,175972,86555,89417,92465,2014-06-01
5535,阿倍野区,107442,49480,57962,50174,2014-06-01
5536,西成区,114814,66862,47952,71252,2014-06-01
5537,淀川区,175048,86524,88524,93490,2014-06-01
5538,浪速区,66845,33980,32865,46094,2014-06-01
5539,西淀川区,95873,47298,48575,43049,2014-06-01
5540,大阪市,2679176,1297274,1381902,1344161,2014-06-01
5541,北区,119952,57722,62230,71638,2014-06-01
5542,福島区,71583,33803,37780,37017,2014-06-01
5543,此花区,66625,32499,34126,30438,2014-06-01
5544,都島区,104611,50418,54193,51288,2014-06-01
5545,西区,88912,41976,46936,50395,2014-06-01
5546,港区,82223,40237,41986,40258,2014-06-01
5547,大正区,66211,32330,33881,29552,2014-06-01
5548,天王寺区,74175,34471,39704,37235,2014-06-01
5549,中央区,88033,41147,46886,55930,2014-06-01
5550,城東区,164120,78201,85919,75909,2014-07-01
5551,東成区,80367,38406,41961,39534,2014-07-01
5552,生野区,130574,62819,67755,63329,2014-07-01
5553,旭区,91620,43792,47828,43673,2014-07-01
5554,鶴見区,111160,53222,57938,45941,2014-07-01
5555,東淀川区,175895,86548,89347,92467,2014-07-01
5556,住之江区,124003,59505,64498,56894,2014-07-01
5557,住吉区,153983,72101,81882,72018,2014-07-01
5558,東住吉区,127004,60070,66934,58266,2014-07-01
5559,平野区,197639,93662,103977,88373,2014-07-01
5560,阿倍野区,107463,49499,57964,50205,2014-07-01
5561,淀川区,175153,86627,88526,93594,2014-07-01
5562,西成区,114660,66714,47946,71183,2014-07-01
5563,浪速区,66874,33980,32894,46122,2014-07-01
5564,大阪市,2679187,1297310,1381877,1344746,2014-07-01
5565,北区,120076,57832,62244,71757,2014-07-01
5566,都島区,104545,50372,54173,51275,2014-07-01
5567,福島区,71600,33804,37796,37034,2014-07-01
5568,此花区,66565,32448,34117,30443,2014-07-01
5569,西淀川区,95766,47235,48531,43019,2014-07-01
5570,西区,89375,42209,47166,50609,2014-07-01
5571,港区,82181,40214,41967,40258,2014-07-01
5572,大正区,66144,32313,33831,29529,2014-07-01
5573,天王寺区,74231,34517,39714,37267,2014-07-01
5574,中央区,88189,41220,46969,56047,2014-07-01
5575,東成区,80334,38416,41918,39526,2014-08-01
5576,生野区,130549,62800,67749,63386,2014-08-01
5577,旭区,91618,43781,47837,43668,2014-08-01
5578,城東区,164166,78234,85932,75968,2014-08-01
5579,鶴見区,111165,53228,57937,45947,2014-08-01
5580,住之江区,123906,59448,64458,56877,2014-08-01
5581,東淀川区,175786,86516,89270,92471,2014-08-01
5582,住吉区,154030,72129,81901,71998,2014-08-01
5583,東住吉区,126959,60046,66913,58245,2014-08-01
5584,平野区,197673,93689,103984,88445,2014-08-01
5585,阿倍野区,107394,49440,57954,50203,2014-08-01
5586,淀川区,175123,86612,88511,93565,2014-08-01
5587,西成区,114406,66520,47886,71007,2014-08-01
5588,浪速区,66990,34048,32942,46188,2014-08-01
5589,大阪市,2679315,1297368,1381947,1345075,2014-08-01
5590,北区,120332,57975,62357,71878,2014-08-01
5591,都島区,104537,50357,54180,51262,2014-08-01
5592,福島区,71643,33817,37826,37053,2014-08-01
5593,此花区,66536,32443,34093,30453,2014-08-01
5594,西淀川区,95663,47189,48474,42964,2014-08-01
5595,西区,89628,42349,47279,50716,2014-08-01
5596,港区,82099,40185,41914,40257,2014-08-01
5597,大正区,66062,32252,33810,29508,2014-08-01
5598,天王寺区,74362,34589,39773,37314,2014-08-01
5599,中央区,88354,41305,47049,56176,2014-08-01
5600,東成区,80286,38407,41879,39513,2014-09-01
5601,生野区,130541,62802,67739,63417,2014-09-01
5602,旭区,91615,43794,47821,43645,2014-09-01
5603,城東区,164260,78269,85991,76051,2014-09-01
5604,鶴見区,111214,53262,57952,45974,2014-09-01
5605,住之江区,123900,59456,64444,56878,2014-09-01
5606,住吉区,153966,72100,81866,71939,2014-09-01
5607,東住吉区,126898,60015,66883,58199,2014-09-01
5608,平野区,197459,93590,103869,88437,2014-09-01
5609,東淀川区,175715,86458,89257,92412,2014-09-01
5610,阿倍野区,107382,49431,57951,50205,2014-09-01
5611,西成区,114192,66387,47805,70900,2014-09-01
5612,淀川区,175189,86673,88516,93616,2014-09-01
5613,浪速区,67001,34074,32927,46119,2014-09-01
5614,西淀川区,95649,47194,48455,42927,2014-09-01
5615,大阪市,2679547,1297569,1381978,1345305,2014-09-01
5616,北区,120502,58063,62439,71991,2014-09-01
5617,都島区,104572,50403,54169,51287,2014-09-01
5618,此花区,66582,32473,34109,30495,2014-09-01
5619,福島区,71654,33818,37836,37069,2014-09-01
5620,西区,89757,42405,47352,50784,2014-09-01
5621,港区,82056,40154,41902,40211,2014-09-01
5622,大正区,65981,32212,33769,29501,2014-09-01
5623,天王寺区,74493,34675,39818,37371,2014-09-01
5624,中央区,88683,41454,47229,56364,2014-09-01
5625,西成区,114028,66267,47761,70729,2014-10-01
5626,東成区,80263,38380,41883,39465,2014-10-01
5627,生野区,130520,62786,67734,63442,2014-10-01
5628,旭区,91591,43759,47832,43630,2014-10-01
5629,城東区,164251,78275,85976,76033,2014-10-01
5630,住之江区,123910,59469,64441,56889,2014-10-01
5631,阿倍野区,107320,49388,57932,50168,2014-10-01
5632,住吉区,154052,72148,81904,71934,2014-10-01
5633,東住吉区,126911,60008,66903,58135,2014-10-01
5634,平野区,197428,93572,103856,88477,2014-10-01
5635,鶴見区,111199,53255,57944,45962,2014-10-01
5636,東淀川区,175668,86378,89290,92311,2014-10-01
5637,淀川区,175013,86590,88423,93472,2014-10-01
5638,浪速区,67169,34123,33046,46149,2014-10-01
5639,大阪市,2679808,1297452,1382356,1345055,2014-10-01
5640,北区,120672,58186,62486,72075,2014-10-01
5641,都島区,104546,50383,54163,51275,2014-10-01
5642,福島区,71765,33873,37892,37091,2014-10-01
5643,此花区,66542,32453,34089,30493,2014-10-01
5644,西淀川区,95762,47218,48544,42979,2014-10-01
5645,西区,89740,42387,47353,50734,2014-10-01
5646,港区,82067,40146,41921,40216,2014-10-01
5647,大正区,65929,32178,33751,29480,2014-10-01
5648,天王寺区,74499,34650,39849,37379,2014-10-01
5649,中央区,88963,41580,47383,56537,2014-10-01
5650,東成区,80282,38371,41911,39465,2014-11-01
5651,生野区,130559,62841,67718,63427,2014-11-01
5652,旭区,91573,43741,47832,43607,2014-11-01
5653,城東区,164196,78287,85909,75939,2014-11-01
5654,鶴見区,111187,53243,57944,45978,2014-11-01
5655,住之江区,123860,59454,64406,56873,2014-11-01
5656,住吉区,154090,72157,81933,71954,2014-11-01
5657,東住吉区,126848,59956,66892,58099,2014-11-01
5658,平野区,197408,93540,103868,88503,2014-11-01
5659,東淀川区,175571,86324,89247,92243,2014-11-01
5660,阿倍野区,107365,49411,57954,50149,2014-11-01
5661,淀川区,175126,86676,88450,93474,2014-11-01
5662,西成区,113987,66210,47777,70642,2014-11-01
5663,浪速区,67618,34341,33277,46304,2014-11-01
5664,大阪市,2680715,1297864,1382851,1345270,2014-11-01
5665,北区,120688,58172,62516,72139,2014-11-01
5666,都島区,104598,50417,54181,51295,2014-11-01
5667,福島区,71873,33927,37946,37137,2014-11-01
5668,此花区,66517,32440,34077,30485,2014-11-01
5669,西淀川区,95688,47202,48486,42961,2014-11-01
5670,西区,89855,42466,47389,50746,2014-11-01
5671,港区,82044,40126,41918,40240,2014-11-01
5672,大正区,65890,32146,33744,29463,2014-11-01
5673,天王寺区,74569,34681,39888,37411,2014-11-01
5674,中央区,89323,41735,47588,56736,2014-11-01
5675,東成区,80274,38355,41919,39458,2014-12-01
5676,生野区,130439,62773,67666,63391,2014-12-01
5677,旭区,91575,43737,47838,43603,2014-12-01
5678,城東区,164213,78289,85924,75921,2014-12-01
5679,鶴見区,111244,53263,57981,45992,2014-12-01
5680,住之江区,123828,59454,64374,56887,2014-12-01
5681,住吉区,153946,72086,81860,71856,2014-12-01
5682,東住吉区,126762,59909,66853,58028,2014-12-01
5683,平野区,197326,93481,103845,88522,2014-12-01
5684,東淀川区,175568,86350,89218,92210,2014-12-01
5685,阿倍野区,107375,49440,57935,50151,2014-12-01
5686,西成区,113707,66006,47701,70491,2014-12-01
5687,淀川区,175019,86618,88401,93390,2014-12-01
5688,浪速区,67708,34385,33323,46317,2014-12-01
5689,西淀川区,95647,47167,48480,42908,2014-12-01
5690,大阪市,2680322,1297623,1382699,1345016,2014-12-01
5691,北区,120815,58252,62563,72215,2014-12-01
5692,福島区,71852,33933,37919,37093,2014-12-01
5693,此花区,66484,32425,34059,30479,2014-12-01
5694,都島区,104557,50397,54160,51284,2014-12-01
5695,西区,89925,42490,47435,50762,2014-12-01
5696,港区,82056,40136,41920,40251,2014-12-01
5697,大正区,65831,32118,33713,29450,2014-12-01
5698,天王寺区,74664,34726,39938,37456,2014-12-01
5699,中央区,89507,41833,47674,56901,2014-12-01
5700,城東区,164242,78285,85957,75921,2015-01-01
5701,東成区,80233,38321,41912,39422,2015-01-01
5702,生野区,130324,62709,67615,63339,2015-01-01
5703,旭区,91585,43749,47836,43620,2015-01-01
5704,阿倍野区,107415,49464,57951,50125,2015-01-01
5705,東淀川区,175410,86227,89183,92145,2015-01-01
5706,住吉区,153960,72060,81900,71773,2015-01-01
5707,東住吉区,126697,59879,66818,57960,2015-01-01
5708,平野区,197222,93444,103778,88510,2015-01-01
5709,西成区,113452,65827,47625,70335,2015-01-01
5710,住之江区,123743,59420,64323,56868,2015-01-01
5711,淀川区,175074,86627,88447,93360,2015-01-01
5712,鶴見区,111236,53252,57984,46014,2015-01-01
5713,浪速区,67816,34447,33369,46272,2015-01-01
5714,北区,121024,58403,62621,72316,2015-01-01
5715,都島区,104486,50360,54126,51204,2015-01-01
5716,福島区,71833,33911,37922,37067,2015-01-01
5717,此花区,66430,32404,34026,30460,2015-01-01
5718,中央区,89861,42001,47860,57123,2015-01-01
5719,大阪市,2680155,1297396,1382759,1344649,2015-01-01
5720,西区,89902,42457,47445,50779,2015-01-01
5721,港区,82147,40190,41957,40276,2015-01-01
5722,大正区,65751,32079,33672,29423,2015-01-01
5723,天王寺区,74800,34808,39992,37515,2015-01-01
5724,西淀川区,95512,47072,48440,42822,2015-01-01
5725,生野区,130275,62707,67568,63310,2015-02-01
5726,旭区,91575,43758,47817,43605,2015-02-01
5727,城東区,164283,78303,85980,75942,2015-02-01
5728,鶴見区,111226,53250,57976,45993,2015-02-01
5729,阿倍野区,107327,49442,57885,50098,2015-02-01
5730,住吉区,153988,72078,81910,71747,2015-02-01
5731,東住吉区,126693,59882,66811,57935,2015-02-01
5732,平野区,197259,93438,103821,88545,2015-02-01
5733,西成区,113282,65672,47610,70181,2015-02-01
5734,東成区,80185,38291,41894,39395,2015-02-01
5735,住之江区,123676,59413,64263,56849,2015-02-01
5736,東淀川区,175425,86257,89168,92097,2015-02-01
5737,淀川区,175005,86577,88428,93294,2015-02-01
5738,西淀川区,95437,47010,48427,42739,2015-02-01
5739,北区,121232,58538,62694,72421,2015-02-01
5740,都島区,104507,50366,54141,51198,2015-02-01
5741,福島区,71870,33941,37929,37063,2015-02-01
5742,此花区,66413,32404,34009,30433,2015-02-01
5743,中央区,90108,42161,47947,57221,2015-02-01
5744,大阪市,2680486,1297555,1382931,1344411,2015-02-01
5745,港区,82163,40178,41985,40268,2015-02-01
5746,大正区,65655,32034,33621,29372,2015-02-01
5747,天王寺区,74840,34815,40025,37515,2015-02-01
5748,浪速区,67997,34538,33459,46382,2015-02-01
5749,西区,90065,42502,47563,50808,2015-02-01
5750,東成区,80208,38321,41887,39392,2015-03-01
5751,生野区,130272,62746,67526,63370,2015-03-01
5752,旭区,91514,43727,47787,43598,2015-03-01
5753,城東区,164147,78255,85892,75888,2015-03-01
5754,鶴見区,111246,53257,57989,46013,2015-03-01
5755,住之江区,123594,59386,64208,56834,2015-03-01
5756,住吉区,153898,72010,81888,71689,2015-03-01
5757,東住吉区,126586,59804,66782,57879,2015-03-01
5758,平野区,197155,93368,103787,88566,2015-03-01
5759,東淀川区,175321,86201,89120,92096,2015-03-01
5760,阿倍野区,107362,49445,57917,50074,2015-03-01
5761,淀川区,174976,86571,88405,93260,2015-03-01
5762,西成区,113030,65507,47523,70078,2015-03-01
5763,浪速区,68103,34607,33496,46478,2015-03-01
5764,大阪市,2680203,1297433,1382770,1344580,2015-03-01
5765,北区,121320,58601,62719,72506,2015-03-01
5766,都島区,104487,50379,54108,51202,2015-03-01
5767,福島区,71886,33955,37931,37046,2015-03-01
5768,此花区,66504,32460,34044,30520,2015-03-01
5769,西淀川区,95457,47019,48438,42777,2015-03-01
5770,西区,90133,42518,47615,50806,2015-03-01
5771,港区,82179,40204,41975,40278,2015-03-01
5772,大正区,65574,31986,33588,29360,2015-03-01
5773,天王寺区,74968,34886,40082,37555,2015-03-01
5774,中央区,90283,42220,48063,57315,2015-03-01
5775,東成区,80268,38344,41924,39536,2015-04-01
5776,生野区,130267,62756,67511,63511,2015-04-01
5777,旭区,91547,43726,47821,43670,2015-04-01
5778,城東区,164314,78286,86028,76159,2015-04-01
5779,鶴見区,111398,53347,58051,46217,2015-04-01
5780,住之江区,123379,59248,64131,56873,2015-04-01
5781,住吉区,153966,71996,81970,71823,2015-04-01
5782,東住吉区,126582,59791,66791,57996,2015-04-01
5783,平野区,196869,93247,103622,88697,2015-04-01
5784,東淀川区,175377,86246,89131,92409,2015-04-01
5785,阿倍野区,107442,49479,57963,50092,2015-04-01
5786,淀川区,175410,86795,88615,93820,2015-04-01
5787,西成区,112815,65377,47438,70001,2015-04-01
5788,浪速区,68446,34801,33645,46822,2015-04-01
5789,大阪市,2682972,1298485,1384487,1349418,2015-04-01
5790,北区,121988,58890,63098,73170,2015-04-01
5791,都島区,104550,50399,54151,51353,2015-04-01
5792,福島区,71988,33960,38028,37214,2015-04-01
5793,此花区,66537,32475,34062,30608,2015-04-01
5794,西淀川区,95431,47034,48397,42875,2015-04-01
5795,西区,90802,42821,47981,51336,2015-04-01
5796,港区,82177,40191,41986,40392,2015-04-01
5797,大正区,65486,31928,33558,29340,2015-04-01
5798,天王寺区,74954,34848,40106,37657,2015-04-01
5799,中央区,90979,42500,48479,57847,2015-04-01
5800,東成区,80378,38422,41956,39593,2015-05-01
5801,生野区,130486,62892,67594,63606,2015-05-01
5802,旭区,91703,43765,47938,43734,2015-05-01
5803,城東区,164467,78371,86096,76297,2015-05-01
5804,鶴見区,111385,53325,58060,46266,2015-05-01
5805,住之江区,123363,59262,64101,56936,2015-05-01
5806,住吉区,154110,72078,82032,71857,2015-05-01
5807,東住吉区,126576,59798,66778,58025,2015-05-01
5808,平野区,196871,93275,103596,88767,2015-05-01
5809,東淀川区,175445,86228,89217,92515,2015-05-01
5810,阿倍野区,107575,49527,58048,50178,2015-05-01
5811,西成区,112757,65314,47443,69922,2015-05-01
5812,淀川区,175705,86973,88732,94099,2015-05-01
5813,浪速区,69106,35181,33925,47145,2015-05-01
5814,西淀川区,95467,47034,48433,42944,2015-05-01
5815,大阪市,2687018,1300541,1386477,1352179,2015-05-01
5816,北区,122500,59166,63334,73524,2015-05-01
5817,福島区,72065,33979,38086,37282,2015-05-01
5818,此花区,66536,32474,34062,30640,2015-05-01
5819,都島区,104671,50433,54238,51446,2015-05-01
5820,西区,91527,43161,48366,51713,2015-05-01
5821,港区,82177,40206,41971,40410,2015-05-01
5822,大正区,65411,31895,33516,29314,2015-05-01
5823,天王寺区,75175,34946,40229,37754,2015-05-01
5824,中央区,91562,42836,48726,58212,2015-05-01
5825,城東区,164454,78356,86098,76300,2015-06-01
5826,東成区,80400,38424,41976,39604,2015-06-01
5827,生野区,130443,62840,67603,63598,2015-06-01
5828,旭区,91675,43772,47903,43740,2015-06-01
5829,阿倍野区,107572,49506,58066,50181,2015-06-01
5830,東淀川区,175507,86284,89223,92551,2015-06-01
5831,住吉区,154145,72091,82054,71826,2015-06-01
5832,東住吉区,126552,59764,66788,57994,2015-06-01
5833,平野区,196894,93313,103581,88826,2015-06-01
5834,西成区,112550,65181,47369,69822,2015-06-01
5835,住之江区,123277,59256,64021,56956,2015-06-01
5836,淀川区,175904,87080,88824,94250,2015-06-01
5837,鶴見区,111444,53339,58105,46302,2015-06-01
5838,浪速区,69160,35234,33926,47218,2015-06-01
5839,北区,122844,59363,63481,73738,2015-06-01
5840,都島区,104658,50440,54218,51431,2015-06-01
5841,福島区,72233,34043,38190,37359,2015-06-01
5842,此花区,66526,32465,34061,30638,2015-06-01
5843,中央区,91973,43054,48919,58439,2015-06-01
5844,大阪市,2688442,1301221,1387221,1353180,2015-06-01
5845,西区,91857,43319,48538,51889,2015-06-01
5846,港区,82134,40173,41961,40411,2015-06-01
5847,大正区,65399,31903,33496,29306,2015-06-01
5848,天王寺区,75318,35002,40316,37835,2015-06-01
5849,西淀川区,95523,47019,48504,42966,2015-06-01
5850,東成区,80409,38433,41976,39627,2015-07-01
5851,生野区,130370,62798,67572,63625,2015-07-01
5852,旭区,91679,43789,47890,43749,2015-07-01
5853,城東区,164526,78376,86150,76319,2015-07-01
5854,鶴見区,111480,53356,58124,46326,2015-07-01
5855,住之江区,123185,59214,63971,56933,2015-07-01
5856,住吉区,154370,72202,82168,71874,2015-07-01
5857,東住吉区,126505,59734,66771,57947,2015-07-01
5858,平野区,196868,93332,103536,88875,2015-07-01
5859,東淀川区,175456,86258,89198,92553,2015-07-01
5860,阿倍野区,107606,49509,58097,50185,2015-07-01
5861,淀川区,175914,87092,88822,94263,2015-07-01
5862,西成区,112353,65012,47341,69636,2015-07-01
5863,浪速区,69261,35308,33953,47358,2015-07-01
5864,大阪市,2689003,1301537,1387466,1353736,2015-07-01
5865,北区,123017,59455,63562,73843,2015-07-01
5866,都島区,104592,50415,54177,51434,2015-07-01
5867,福島区,72256,34064,38192,37374,2015-07-01
5868,此花区,66520,32484,34036,30657,2015-07-01
5869,西淀川区,95623,47084,48539,43011,2015-07-01
5870,西区,92099,43423,48676,52050,2015-07-01
5871,港区,82073,40137,41936,40397,2015-07-01
5872,大正区,65346,31897,33449,29285,2015-07-01
5873,天王寺区,75346,35013,40333,37841,2015-07-01
5874,中央区,92149,43152,48997,58574,2015-07-01
5875,東成区,80510,38505,42005,39666,2015-08-01
5876,生野区,130348,62812,67536,63591,2015-08-01
5877,旭区,91655,43774,47881,43740,2015-08-01
5878,城東区,164621,78432,86189,76374,2015-08-01
5879,鶴見区,111564,53398,58166,46373,2015-08-01
5880,住之江区,123132,59194,63938,56943,2015-08-01
5881,住吉区,154233,72074,82159,71819,2015-08-01
5882,東住吉区,126445,59727,66718,57896,2015-08-01
5883,平野区,196797,93273,103524,88895,2015-08-01
5884,東淀川区,175485,86302,89183,92519,2015-08-01
5885,阿倍野区,107617,49525,58092,50165,2015-08-01
5886,西成区,112199,64892,47307,69506,2015-08-01
5887,淀川区,175947,87139,88808,94248,2015-08-01
5888,浪速区,69597,35467,34130,47428,2015-08-01
5889,西淀川区,95632,47062,48570,43006,2015-08-01
5890,大阪市,2689946,1301985,1387961,1353958,2015-08-01
5891,北区,123091,59536,63555,73905,2015-08-01
5892,福島区,72343,34103,38240,37398,2015-08-01
5893,此花区,66596,32535,34061,30681,2015-08-01
5894,都島区,104665,50464,54201,51455,2015-08-01
5895,西区,92264,43501,48763,52099,2015-08-01
5896,港区,82080,40131,41949,40370,2015-08-01
5897,大正区,65256,31822,33434,29282,2015-08-01
5898,天王寺区,75389,35047,40342,37857,2015-08-01
5899,中央区,92480,43270,49210,58742,2015-08-01
5900,鶴見区,111576,53444,58132,46371,2015-09-01
5901,生野区,130231,62792,67439,63614,2015-09-01
5902,旭区,91603,43737,47866,43710,2015-09-01
5903,城東区,164650,78435,86215,76410,2015-09-01
5904,西成区,111955,64725,47230,69291,2015-09-01
5905,東成区,80545,38526,42019,39674,2015-09-01
5906,住之江区,123084,59196,63888,56949,2015-09-01
5907,住吉区,154180,72032,82148,71740,2015-09-01
5908,東住吉区,126344,59665,66679,57856,2015-09-01
5909,平野区,196681,93270,103411,88928,2015-09-01
5910,阿倍野区,107621,49516,58105,50140,2015-09-01
5911,東淀川区,175466,86311,89155,92499,2015-09-01
5912,中央区,92804,43433,49371,58983,2015-09-01
5913,西淀川区,95567,47016,48551,42972,2015-09-01
5914,浪速区,69697,35489,34208,47534,2015-09-01
5915,天王寺区,75571,35137,40434,37963,2015-09-01
5916,大正区,65190,31806,33384,29244,2015-09-01
5917,港区,82081,40136,41945,40357,2015-09-01
5918,西区,92258,43501,48757,52060,2015-09-01
5919,此花区,66632,32569,34063,30722,2015-09-01
5920,福島区,72388,34142,38246,37459,2015-09-01
5921,都島区,104642,50468,54174,51502,2015-09-01
5922,北区,123279,59644,63635,74009,2015-09-01
5923,大阪市,2690112,1302217,1387895,1354379,2015-09-01
5924,淀川区,176067,87227,88840,94392,2015-09-01
5925,東成区,80563,38547,42016,39683,2015-10-01
5926,生野区,130167,62670,67497,63622,2015-10-01
5927,旭区,91608,43760,47848,43700,2015-10-01
5928,城東区,164697,78463,86234,76455,2015-10-01
5929,西成区,111883,64639,47244,69225,2015-10-01
5930,住之江区,122988,59131,63857,56920,2015-10-01
5931,住吉区,154239,72068,82171,71718,2015-10-01
5932,東住吉区,126299,59645,66654,57797,2015-10-01
5933,平野区,196633,93242,103391,88960,2015-10-01
5934,東淀川区,175530,86372,89158,92536,2015-10-01
5935,阿倍野区,107626,49519,58107,50104,2015-10-01
5936,淀川区,176201,87316,88885,94460,2015-10-01
5937,鶴見区,111557,53439,58118,46358,2015-10-01
5938,浪速区,69766,35475,34291,47541,2015-10-01
5939,天王寺区,75729,35201,40528,38058,2015-10-01
5940,大正区,65141,31794,33347,29209,2015-10-01
5941,港区,82035,40096,41939,40348,2015-10-01
5942,西区,92430,43582,48848,52138,2015-10-01
5943,中央区,93069,43528,49541,59084,2015-10-01
5944,此花区,66656,32580,34076,30712,2015-10-01
5945,福島区,72484,34168,38316,37510,2015-10-01
5946,都島区,104727,50528,54199,51549,2015-10-01
5947,北区,123667,59820,63847,74182,2015-10-01
5948,大阪市,2691185,1302562,1388623,1354793,2015-10-01
5949,西淀川区,95490,46979,48511,42924,2015-10-01
5950,浪速区,70142,34526,35616,47853,2015-11-01 00:00:00
5951,天王寺区,75858,40564,35294,38149,2015-11-01 00:00:00
5952,大正区,65126,33354,31772,29213,2015-11-01 00:00:00
5953,港区,82032,41922,40110,40365,2015-11-01 00:00:00
5954,都島区,104722,54199,50523,51600,2015-11-01 00:00:00
5955,中央区,93355,49709,43646,59289,2015-11-01 00:00:00
5956,此花区,66639,34061,32578,30721,2015-11-01 00:00:00
5957,福島区,72549,38359,34190,37537,2015-11-01 00:00:00
5958,西淀川区,95472,48500,46972,42925,2015-11-01 00:00:00
5959,西区,92729,49016,43713,52363,2015-11-01 00:00:00
5960,淀川区,176343,88975,87368,94595,2015-11-01 00:00:00
5961,西成区,111926,47223,64703,69346,2015-11-01 00:00:00
5962,東成区,80562,42024,38538,39698,2015-11-01 00:00:00
5963,生野区,130220,67546,62674,63774,2015-11-01 00:00:00
5964,旭区,91560,47838,43722,43653,2015-11-01 00:00:00
5965,城東区,164794,86281,78513,76567,2015-11-01 00:00:00
5966,阿倍野区,107876,58196,49680,50274,2015-11-01 00:00:00
5967,住之江区,122882,63817,59065,56912,2015-11-01 00:00:00
5968,住吉区,154234,82200,72034,71765,2015-11-01 00:00:00
5969,東住吉区,126248,66654,59594,57802,2015-11-01 00:00:00
5970,平野区,196634,103385,93249,89050,2015-11-01 00:00:00
5971,北区,123821,63957,59864,74234,2015-11-01 00:00:00
5972,東淀川区,175544,89157,86387,92655,2015-11-01 00:00:00
5973,大阪市,2692763,1389546,1303217,1356691,2015-11-01 00:00:00
5974,鶴見区,111495,58083,53412,46351,2015-11-01 00:00:00
5975,平野区,196563,103362,93201,89063,2015-12-01 00:00:00
5976,大阪市,2692960,1389666,1303294,1357376,2015-12-01 00:00:00
5977,北区,123984,64025,59959,74357,2015-12-01 00:00:00
5978,都島区,104722,54187,50535,51606,2015-12-01 00:00:00
5979,福島区,72531,38346,34185,37541,2015-12-01 00:00:00
5980,此花区,66595,34048,32547,30716,2015-12-01 00:00:00
5981,中央区,93425,49763,43662,59369,2015-12-01 00:00:00
5982,西区,92883,49103,43780,52460,2015-12-01 00:00:00
5983,港区,82051,41940,40111,40398,2015-12-01 00:00:00
5984,大正区,65065,33325,31740,29184,2015-12-01 00:00:00
5985,天王寺区,75891,40570,35321,38182,2015-12-01 00:00:00
5986,浪速区,70322,34610,35712,47946,2015-12-01 00:00:00
5987,西成区,111839,47188,64651,69319,2015-12-01 00:00:00
5988,淀川区,176304,88948,87356,94601,2015-12-01 00:00:00
5989,東淀川区,175590,89163,86427,92798,2015-12-01 00:00:00
5990,東成区,80509,42008,38501,39674,2015-12-01 00:00:00
5991,生野区,130082,67504,62578,63721,2015-12-01 00:00:00
5992,旭区,91504,47832,43672,43621,2015-12-01 00:00:00
5993,城東区,164868,86332,78536,76671,2015-12-01 00:00:00
5994,鶴見区,111493,58079,53414,46353,2015-12-01 00:00:00
5995,阿倍野区,107984,58255,49729,50298,2015-12-01 00:00:00
5996,住之江区,122833,63788,59045,56953,2015-12-01 00:00:00
5997,住吉区,154168,82134,72034,71743,2015-12-01 00:00:00
5998,東住吉区,126284,66674,59610,57854,2015-12-01 00:00:00
5999,西淀川区,95470,48482,46988,42948,2015-12-01 00:00:00
6000,天王寺区,76222,40749,35473,38349,2016-01-01
6001,大正区,64990,33302,31688,29172,2016-01-01
6002,港区,81994,41929,40065,40358,2016-01-01
6003,西成区,111656,47122,64534,69199,2016-01-01
6004,大阪市,2693239,1389860,1303379,1357563,2016-01-01
6005,此花区,66564,34022,32542,30720,2016-01-01
6006,福島区,72644,38401,34243,37589,2016-01-01
6007,都島区,104698,54180,50518,51604,2016-01-01
6008,北区,124200,64152,60048,74464,2016-01-01
6009,浪速区,70429,34685,35744,47987,2016-01-01
6010,中央区,93490,49791,43699,59382,2016-01-01
6011,西淀川区,95400,48459,46941,42930,2016-01-01
6012,西区,93011,49165,43846,52521,2016-01-01
6013,東淀川区,175645,89194,86451,92841,2016-01-01
6014,平野区,196516,103346,93170,89096,2016-01-01
6015,東住吉区,126248,66679,59569,57818,2016-01-01
6016,住吉区,153971,82064,71907,71595,2016-01-01
6017,住之江区,122759,63739,59020,56968,2016-01-01
6018,阿倍野区,108011,58212,49799,50319,2016-01-01
6019,淀川区,176301,88975,87326,94583,2016-01-01
6020,城東区,164890,86350,78540,76656,2016-01-01
6021,旭区,91581,47866,43715,43632,2016-01-01
6022,生野区,129968,67380,62588,63693,2016-01-01
6023,東成区,80566,42025,38541,39736,2016-01-01
6024,鶴見区,111485,58073,53412,46351,2016-01-01
6025,北区,124482,64261,60221,74617,2016-02-01
6026,都島区,104726,54185,50541,51647,2016-02-01
6027,福島区,72667,38438,34229,37631,2016-02-01
6028,此花区,66523,34002,32521,30716,2016-02-01
6029,中央区,93713,49895,43818,59506,2016-02-01
6030,西区,93147,49218,43929,52599,2016-02-01
6031,港区,81932,41905,40027,40312,2016-02-01
6032,大正区,64913,33270,31643,29146,2016-02-01
6033,天王寺区,76319,40811,35508,38397,2016-02-01
6034,浪速区,70618,34763,35855,48122,2016-02-01
6035,東淀川区,175553,89157,86396,92788,2016-02-01
6036,淀川区,176328,88991,87337,94599,2016-02-01
6037,東成区,80517,41990,38527,39692,2016-02-01
6038,生野区,129816,67305,62511,63611,2016-02-01
6039,大阪市,2693201,1389911,1303290,1357787,2016-02-01
6040,城東区,164986,86398,78588,76732,2016-02-01
6041,鶴見区,111494,58058,53436,46364,2016-02-01
6042,阿倍野区,108020,58232,49788,50289,2016-02-01
6043,住之江区,122645,63686,58959,56951,2016-02-01
6044,住吉区,153815,81978,71837,71543,2016-02-01
6045,東住吉区,126192,66648,59544,57855,2016-02-01
6046,西淀川区,95369,48459,46910,42922,2016-02-01
6047,旭区,91510,47846,43664,43600,2016-02-01
6048,西成区,111456,47067,64389,69081,2016-02-01
6049,平野区,196460,103348,93112,89067,2016-02-01
6050,港区,81915,41869,40046,40349,2016-03-01
6051,大阪市,2692845,1389722,1303123,1358464,2016-03-01
6052,北区,124749,64419,60330,74812,2016-03-01
6053,都島区,104831,54251,50580,51743,2016-03-01
6054,福島区,72706,38452,34254,37664,2016-03-01
6055,此花区,66517,34017,32500,30752,2016-03-01
6056,中央区,93765,49926,43839,59559,2016-03-01
6057,西区,93275,49309,43966,52708,2016-03-01
6058,大正区,64828,33204,31624,29146,2016-03-01
6059,天王寺区,76390,40828,35562,38460,2016-03-01
6060,浪速区,70648,34762,35886,48172,2016-03-01
6061,淀川区,176210,88936,87274,94580,2016-03-01
6062,西淀川区,95357,48469,46888,42942,2016-03-01
6063,東成区,80507,41980,38527,39713,2016-03-01
6064,西成区,111267,46994,64273,68968,2016-03-01
6065,平野区,196336,103260,93076,89085,2016-03-01
6066,東住吉区,126138,66629,59509,57827,2016-03-01
6067,住吉区,153695,81926,71769,71506,2016-03-01
6068,東淀川区,175464,89067,86397,92865,2016-03-01
6069,阿倍野区,108063,58242,49821,50321,2016-03-01
6070,住之江区,122591,63667,58924,56979,2016-03-01
6071,城東区,164958,86380,78578,76760,2016-03-01
6072,旭区,91442,47814,43628,43573,2016-03-01
6073,生野区,129709,67240,62469,63590,2016-03-01
6074,鶴見区,111484,58081,53403,46390,2016-03-01
6075,浪速区,70715,34738,35977,48314,2016-04-01
6076,港区,81878,41878,40000,40435,2016-04-01
6077,天王寺区,76422,40889,35533,38505,2016-04-01
6078,大正区,64738,33173,31565,29193,2016-04-01
6079,西区,93937,49684,44253,53204,2016-04-01
6080,福島区,72960,38592,34368,37958,2016-04-01
6081,此花区,66445,33982,32463,30800,2016-04-01
6082,都島区,105013,54384,50629,52068,2016-04-01
6083,北区,125072,64674,60398,75177,2016-04-01
6084,大阪市,2694610,1391293,1303317,1363598,2016-04-01
6085,西淀川区,95279,48429,46850,43072,2016-04-01
6086,中央区,94365,50282,44083,60072,2016-04-01
6087,淀川区,176700,89255,87445,95237,2016-04-01
6088,住之江区,122391,63591,58800,57097,2016-04-01
6089,東成区,80538,42044,38494,39879,2016-04-01
6090,東淀川区,175675,89209,86466,93455,2016-04-01
6091,平野区,196058,103093,92965,89258,2016-04-01
6092,東住吉区,126091,66712,59379,57921,2016-04-01
6093,住吉区,153651,81899,71752,71677,2016-04-01
6094,西成区,111097,46941,64156,68934,2016-04-01
6095,鶴見区,111473,58077,53396,46504,2016-04-01
6096,城東区,165007,86454,78553,77029,2016-04-01
6097,旭区,91470,47847,43623,43708,2016-04-01
6098,生野区,129650,67220,62430,63752,2016-04-01
6099,阿倍野区,107985,58246,49739,50349,2016-04-01
6100,西淀川区,95389,48492,46897,43217,2016-05-01
6101,浪速区,70951,34896,36055,48560,2016-05-01
6102,天王寺区,76734,41065,35669,38707,2016-05-01
6103,大正区,64683,33134,31549,29225,2016-05-01
6104,港区,81822,41851,39971,40469,2016-05-01
6105,西区,94707,50087,44620,53691,2016-05-01
6106,福島区,73038,38635,34403,38033,2016-05-01
6107,此花区,66428,33964,32464,30860,2016-05-01
6108,都島区,105248,54458,50790,52281,2016-05-01
6109,北区,125490,64900,60590,75480,2016-05-01
6110,大阪市,2699164,1393647,1305517,1368603,2016-05-01
6111,中央区,94857,50552,44305,60389,2016-05-01
6112,淀川区,177195,89445,87750,95720,2016-05-01
6113,東成区,80676,42123,38553,40040,2016-05-01
6114,西成区,111281,47026,64255,69191,2016-05-01
6115,生野区,129964,67378,62586,64196,2016-05-01
6116,旭区,91574,47925,43649,43853,2016-05-01
6117,城東区,165125,86531,78594,77233,2016-05-01
6118,鶴見区,111468,58076,53392,46554,2016-05-01
6119,阿倍野区,108223,58359,49864,50599,2016-05-01
6120,住之江区,122390,63604,58786,57196,2016-05-01
6121,住吉区,153860,81984,71876,71885,2016-05-01
6122,東住吉区,126229,66776,59453,58102,2016-05-01
6123,平野区,195961,103076,92885,89373,2016-05-01
6124,東淀川区,175871,89310,86561,93749,2016-05-01
6125,大正区,64677,33126,31551,29267,2016-06-01
6126,港区,81779,41845,39934,40471,2016-06-01
6127,西区,94901,50192,44709,53812,2016-06-01
6128,東住吉区,126149,66736,59413,58119,2016-06-01
6129,此花区,66430,33960,32470,30884,2016-06-01
6130,福島区,73178,38686,34492,38151,2016-06-01
6131,都島区,105342,54495,50847,52351,2016-06-01
6132,天王寺区,76924,41167,35757,38788,2016-06-01
6133,中央区,95024,50645,44379,60543,2016-06-01
6134,浪速区,70961,34892,36069,48603,2016-06-01
6135,旭区,91512,47884,43628,43855,2016-06-01
6136,淀川区,177480,89521,87959,95999,2016-06-01
6137,東淀川区,175751,89239,86512,93794,2016-06-01
6138,東成区,80668,42116,38552,40079,2016-06-01
6139,生野区,129960,67399,62561,64286,2016-06-01
6140,城東区,165110,86548,78562,77276,2016-06-01
6141,鶴見区,111465,58086,53379,46614,2016-06-01
6142,阿倍野区,108140,58285,49855,50600,2016-06-01
6143,住之江区,122295,63536,58759,57230,2016-06-01
6144,住吉区,153861,81965,71896,71923,2016-06-01
6145,北区,125541,64920,60621,75524,2016-06-01
6146,大阪市,2699636,1393755,1305881,1369985,2016-06-01
6147,西淀川区,95372,48501,46871,43217,2016-06-01
6148,西成区,111183,46967,64216,69152,2016-06-01
6149,平野区,195933,103044,92889,89447,2016-06-01
6150,大阪市,2700732,1394245,1306487,1371253,2016-07-01
6151,北区,125666,64989,60677,75561,2016-07-01
6152,都島区,105425,54535,50890,52430,2016-07-01
6153,福島区,73266,38727,34539,38236,2016-07-01
6154,此花区,66357,33906,32451,30880,2016-07-01
6155,中央区,95160,50736,44424,60614,2016-07-01
6156,西区,95050,50230,44820,53896,2016-07-01
6157,港区,81685,41786,39899,40455,2016-07-01
6158,大正区,64685,33119,31566,29301,2016-07-01
6159,天王寺区,77029,41215,35814,38831,2016-07-01
6160,東住吉区,126212,66769,59443,58183,2016-07-01
6161,平野区,195990,103070,92920,89549,2016-07-01
6162,淀川区,177656,89557,88099,96134,2016-07-01
6163,東淀川区,175714,89240,86474,93805,2016-07-01
6164,東成区,80732,42157,38575,40165,2016-07-01
6165,生野区,129939,67371,62568,64330,2016-07-01
6166,旭区,91516,47903,43613,43879,2016-07-01
6167,城東区,165254,86608,78646,77374,2016-07-01
6168,鶴見区,111479,58098,53381,46638,2016-07-01
6169,阿倍野区,108226,58325,49901,50669,2016-07-01
6170,住之江区,122205,63506,58699,57263,2016-07-01
6171,住吉区,154029,82081,71948,72084,2016-07-01
6172,西成区,111110,46929,64181,69115,2016-07-01
6173,西淀川区,95413,48530,46883,43271,2016-07-01
6174,浪速区,70934,34858,36076,48590,2016-07-01
6175,西成区,111139,46935,64204,69167,2016-08-01
6176,港区,81670,41787,39883,40446,2016-08-01
6177,大阪市,2701880,1394844,1307036,1372136,2016-08-01
6178,北区,125887,65083,60804,75659,2016-08-01
6179,都島区,105518,54602,50916,52490,2016-08-01
6180,福島区,73343,38745,34598,38276,2016-08-01
6181,此花区,66350,33917,32433,30882,2016-08-01
6182,中央区,95357,50833,44524,60687,2016-08-01
6183,西区,95264,50343,44921,54011,2016-08-01
6184,大正区,64681,33110,31571,29296,2016-08-01
6185,天王寺区,77128,41252,35876,38873,2016-08-01
6186,西淀川区,95455,48535,46920,43318,2016-08-01
6187,淀川区,177710,89579,88131,96185,2016-08-01
6188,浪速区,71035,34939,36096,48630,2016-08-01
6189,東成区,80806,42185,38621,40224,2016-08-01
6190,生野区,129915,67380,62535,64347,2016-08-01
6191,旭区,91447,47867,43580,43854,2016-08-01
6192,城東区,165332,86634,78698,77445,2016-08-01
6193,鶴見区,111550,58151,53399,46669,2016-08-01
6194,阿倍野区,108210,58325,49885,50670,2016-08-01
6195,住之江区,122224,63519,58705,57331,2016-08-01
6196,住吉区,153968,82082,71886,72037,2016-08-01
6197,東住吉区,126290,66782,59508,58251,2016-08-01
6198,平野区,195951,103056,92895,89638,2016-08-01
6199,東淀川区,175650,89203,86447,93750,2016-08-01
6200,西区,95403,50404,44999,54051,2016-09-01
6201,浪速区,71010,34908,36102,48653,2016-09-01
6202,天王寺区,77247,41338,35909,38930,2016-09-01
6203,大正区,64641,33098,31543,29326,2016-09-01
6204,中央区,95381,50822,44559,60749,2016-09-01
6205,大阪市,2701728,1394620,1307108,1373095,2016-09-01
6206,福島区,73331,38724,34607,38286,2016-09-01
6207,都島区,105565,54618,50947,52577,2016-09-01
6208,北区,125987,65142,60845,75764,2016-09-01
6209,西淀川区,95409,48479,46930,43351,2016-09-01
6210,此花区,66336,33912,32424,30910,2016-09-01
6211,淀川区,177746,89568,88178,96285,2016-09-01
6212,港区,81614,41733,39881,40466,2016-09-01
6213,東成区,80834,42205,38629,40317,2016-09-01
6214,平野区,195770,102970,92800,89657,2016-09-01
6215,東住吉区,126261,66745,59516,58282,2016-09-01
6216,住吉区,153935,82055,71880,72069,2016-09-01
6217,住之江区,122198,63485,58713,57391,2016-09-01
6218,阿倍野区,108188,58289,49899,50690,2016-09-01
6219,西成区,110994,46876,64118,69121,2016-09-01
6220,鶴見区,111582,58139,53443,46722,2016-09-01
6221,生野区,129824,67355,62469,64308,2016-09-01
6222,東淀川区,175646,89208,86438,93850,2016-09-01
6223,城東区,165374,86657,78717,77477,2016-09-01
6224,旭区,91452,47890,43562,43863,2016-09-01
6225,淀川区,177868,89627,88241,96394,2016-10-01
6226,都島区,105779,54741,51038,52714,2016-10-01
6227,福島区,73352,38736,34616,38281,2016-10-01
6228,此花区,66421,33960,32461,30937,2016-10-01
6229,北区,125983,65102,60881,75756,2016-10-01
6230,西区,95522,50492,45030,54104,2016-10-01
6231,港区,81551,41722,39829,40448,2016-10-01
6232,大正区,64672,33112,31560,29338,2016-10-01
6233,天王寺区,77290,41358,35932,38938,2016-10-01
6234,浪速区,71001,34941,36060,48645,2016-10-01
6235,西淀川区,95374,48457,46917,43358,2016-10-01
6236,中央区,95457,50901,44556,60775,2016-10-01
6237,東成区,80733,42160,38573,40262,2016-10-01
6238,生野区,129838,67342,62496,64388,2016-10-01
6239,旭区,91458,47900,43558,43909,2016-10-01
6240,城東区,165360,86649,78711,77497,2016-10-01
6241,鶴見区,111575,58120,53455,46732,2016-10-01
6242,阿倍野区,108193,58278,49915,50692,2016-10-01
6243,住之江区,122195,63480,58715,57408,2016-10-01
6244,住吉区,153869,82013,71856,72034,2016-10-01
6245,東住吉区,126231,66749,59482,58262,2016-10-01
6246,平野区,195755,103003,92752,89736,2016-10-01
6247,西成区,110925,46841,64084,69126,2016-10-01
6248,大阪市,2702033,1394871,1307162,1373670,2016-10-01
6249,東淀川区,175631,89187,86444,93936,2016-10-01
6250,大正区,64618,33093,31525,29318,2016-11-01
6251,港区,81568,41695,39873,40513,2016-11-01
6252,西区,95828,50683,45145,54287,2016-11-01
6253,中央区,95484,50897,44587,60788,2016-11-01
6254,天王寺区,77325,41370,35955,38955,2016-11-01
6255,福島区,73430,38783,34647,38339,2016-11-01
6256,都島区,105869,54796,51073,52817,2016-11-01
6257,北区,126131,65169,60962,75831,2016-11-01
6258,大阪市,2703488,1395634,1307854,1375567,2016-11-01
6259,此花区,66452,33982,32470,30962,2016-11-01
6260,浪速区,71353,35130,36223,48990,2016-11-01
6261,東住吉区,126212,66769,59443,58295,2016-11-01
6262,淀川区,177925,89623,88302,96445,2016-11-01
6263,東淀川区,175625,89189,86436,94047,2016-11-01
6264,東成区,80847,42215,38632,40406,2016-11-01
6265,生野区,130004,67408,62596,64636,2016-11-01
6266,旭区,91449,47890,43559,43950,2016-11-01
6267,城東区,165467,86679,78788,77584,2016-11-01
6268,鶴見区,111530,58094,53436,46754,2016-11-01
6269,阿倍野区,108400,58414,49986,50848,2016-11-01
6270,住之江区,122247,63515,58732,57469,2016-11-01
6271,住吉区,153803,81990,71813,72048,2016-11-01
6272,平野区,195675,102934,92741,89749,2016-11-01
6273,西淀川区,95364,48466,46898,43378,2016-11-01
6274,西成区,110882,46850,64032,69158,2016-11-01
6275,鶴見区,111625,58157,53468,46795,2016-12-01
6276,平野区,195608,102922,92686,89759,2016-12-01
6277,西成区,110737,46791,63946,69123,2016-12-01
6278,大阪市,2703613,1395785,1307828,1375855,2016-12-01
6279,北区,126285,65246,61039,75865,2016-12-01
6280,都島区,105907,54811,51096,52843,2016-12-01
6281,福島区,73584,38853,34731,38396,2016-12-01
6282,此花区,66343,33908,32435,30945,2016-12-01
6283,西区,96008,50785,45223,54389,2016-12-01
6284,港区,81537,41659,39878,40497,2016-12-01
6285,大正区,64599,33084,31515,29346,2016-12-01
6286,天王寺区,77424,41441,35983,38980,2016-12-01
6287,浪速区,71387,35150,36237,48998,2016-12-01
6288,中央区,95553,50972,44581,60843,2016-12-01
6289,淀川区,177930,89656,88274,96428,2016-12-01
6290,東淀川区,175491,89120,86371,94030,2016-12-01
6291,東成区,80876,42188,38688,40454,2016-12-01
6292,生野区,129907,67382,62525,64600,2016-12-01
6293,旭区,91346,47833,43513,43897,2016-12-01
6294,城東区,165515,86730,78785,77592,2016-12-01
6295,阿倍野区,108373,58395,49978,50825,2016-12-01
6296,住之江区,122202,63492,58710,57495,2016-12-01
6297,住吉区,153779,81954,71825,71999,2016-12-01
6298,東住吉区,126144,66740,59404,58305,2016-12-01
6299,西淀川区,95453,48516,46937,43451,2016-12-01
6300,浪速区,71366,35144,36222,48990,2017-01-01
6301,天王寺区,77508,41495,36013,38984,2017-01-01
6302,大正区,64556,33047,31509,29314,2017-01-01
6303,港区,81451,41610,39841,40456,2017-01-01
6304,中央区,95500,50945,44555,60788,2017-01-01
6305,大阪市,2703453,1395856,1307597,1375644,2017-01-01
6306,福島区,73650,38907,34743,38419,2017-01-01
6307,都島区,105894,54780,51114,52811,2017-01-01
6308,北区,126408,65334,61074,75902,2017-01-01
6309,西淀川区,95439,48482,46957,43467,2017-01-01
6310,此花区,66384,33929,32455,30970,2017-01-01
6311,淀川区,178001,89697,88304,96481,2017-01-01
6312,西区,96118,50862,45256,54428,2017-01-01
6313,東成区,81008,42249,38759,40575,2017-01-01
6314,平野区,195590,102933,92657,89803,2017-01-01
6315,東住吉区,126137,66754,59383,58276,2017-01-01
6316,住吉区,153629,81839,71790,71875,2017-01-01
6317,住之江区,122142,63491,58651,57472,2017-01-01
6318,阿倍野区,108343,58376,49967,50766,2017-01-01
6319,西成区,110660,46766,63894,69105,2017-01-01
6320,鶴見区,111665,58158,53507,46809,2017-01-01
6321,生野区,129722,67326,62396,64482,2017-01-01
6322,東淀川区,175406,89074,86332,93971,2017-01-01
6323,城東区,165550,86812,78738,77602,2017-01-01
6324,旭区,91326,47846,43480,43898,2017-01-01
6325,西淀川区,95304,48408,46896,43392,2017-02-01
6326,北区,126541,65391,61150,76025,2017-02-01
6327,都島区,105844,54739,51105,52801,2017-02-01
6328,福島区,73660,38901,34759,38434,2017-02-01
6329,大阪市,2702455,1395317,1307138,1375648,2017-02-01
6330,中央区,95598,50975,44623,60824,2017-02-01
6331,西区,96175,50900,45275,54490,2017-02-01
6332,港区,81314,41534,39780,40377,2017-02-01
6333,大正区,64524,33018,31506,29340,2017-02-01
6334,天王寺区,77571,41525,36046,39004,2017-02-01
6335,浪速区,71356,35132,36224,48973,2017-02-01
6336,此花区,66351,33949,32402,30985,2017-02-01
6337,淀川区,178052,89728,88324,96487,2017-02-01
6338,東成区,80974,42218,38756,40570,2017-02-01
6339,東淀川区,175312,89030,86282,93942,2017-02-01
6340,西成区,110612,46745,63867,69093,2017-02-01
6341,平野区,195413,102830,92583,89728,2017-02-01
6342,住吉区,153530,81776,71754,71898,2017-02-01
6343,住之江区,122037,63434,58603,57495,2017-02-01
6344,東住吉区,126082,66743,59339,58270,2017-02-01
6345,鶴見区,111603,58145,53458,46787,2017-02-01
6346,城東区,165511,86805,78706,77641,2017-02-01
6347,旭区,91218,47761,43457,43889,2017-02-01
6348,生野区,129564,67260,62304,64452,2017-02-01
6349,阿倍野区,108309,58370,49939,50751,2017-02-01
6350,西区,96301,50924,45377,54562,2017-03-01
6351,天王寺区,77661,41570,36091,39046,2017-03-01
6352,大正区,64489,33006,31483,29353,2017-03-01
6353,港区,81262,41483,39779,40373,2017-03-01
6354,中央区,95603,50965,44638,60842,2017-03-01
6355,浪速区,71365,35172,36193,48999,2017-03-01
6356,福島区,73651,38893,34758,38409,2017-03-01
6357,都島区,105919,54785,51134,52857,2017-03-01
6358,北区,126752,65507,61245,76144,2017-03-01
6359,大阪市,2702242,1395241,1307001,1376202,2017-03-01
6360,此花区,66277,33903,32374,30962,2017-03-01
6361,西淀川区,95262,48389,46873,43385,2017-03-01
6362,鶴見区,111646,58157,53489,46817,2017-03-01
6363,東淀川区,175289,89008,86281,93980,2017-03-01
6364,平野区,195271,102791,92480,89721,2017-03-01
6365,東住吉区,126110,66788,59322,58303,2017-03-01
6366,住吉区,153366,81694,71672,71809,2017-03-01
6367,住之江区,121964,63390,58574,57501,2017-03-01
6368,阿倍野区,108303,58369,49934,50770,2017-03-01
6369,西成区,110477,46684,63793,69054,2017-03-01
6370,城東区,165598,86856,78742,77744,2017-03-01
6371,旭区,91069,47690,43379,43862,2017-03-01
6372,生野区,129500,67233,62267,64477,2017-03-01
6373,東成区,81031,42250,38781,40688,2017-03-01
6374,淀川区,178076,89734,88342,96544,2017-03-01
6375,浪速区,71668,35306,36362,49290,2017-04-01
6376,天王寺区,77790,41690,36100,39174,2017-04-01
6377,大正区,64459,32988,31471,29428,2017-04-01
6378,港区,81210,41456,39754,40478,2017-04-01
6379,西区,96532,51103,45429,54845,2017-04-01
6380,此花区,66317,33906,32411,31064,2017-04-01
6381,福島区,73839,39030,34809,38675,2017-04-01
6382,都島区,106083,54949,51134,53173,2017-04-01
6383,北区,127397,65876,61521,76722,2017-04-01
6384,西淀川区,95323,48407,46916,43553,2017-04-01
6385,中央区,95766,51111,44655,61029,2017-04-01
6386,淀川区,178330,89904,88426,97074,2017-04-01
6387,大阪市,2704557,1397063,1307494,1381773,2017-04-01
6388,東成区,81324,42416,38908,41074,2017-04-01
6389,西成区,110458,46685,63773,69174,2017-04-01
6390,平野区,195118,102733,92385,89979,2017-04-01
6391,東住吉区,126077,66799,59278,58429,2017-04-01
6392,住吉区,153199,81654,71545,71908,2017-04-01
6393,住之江区,121979,63435,58544,57636,2017-04-01
6394,東淀川区,175552,89204,86348,94571,2017-04-01
6395,鶴見区,111539,58141,53398,46919,2017-04-01
6396,城東区,165833,86974,78859,78132,2017-04-01
6397,旭区,91037,47706,43331,43975,2017-04-01
6398,生野区,129360,67162,62198,64639,2017-04-01
6399,阿倍野区,108367,58428,49939,50832,2017-04-01
6400,浪速区,72090,35583,36507,49669,2017-05-01
6401,天王寺区,78108,41867,36241,39401,2017-05-01
6402,大正区,64483,33014,31469,29519,2017-05-01
6403,港区,81196,41461,39735,40530,2017-05-01
6404,西区,96871,51315,45556,55194,2017-05-01
6405,此花区,66328,33902,32426,31128,2017-05-01
6406,福島区,73873,39036,34837,38752,2017-05-01
6407,都島区,106123,54990,51133,53302,2017-05-01
6408,北区,128170,66249,61921,77261,2017-05-01
6409,西淀川区,95390,48444,46946,43677,2017-05-01
6410,中央区,96086,51268,44818,61350,2017-05-01
6411,大阪市,2709167,1399551,1309616,1387200,2017-05-01
6412,淀川区,178723,90159,88564,97495,2017-05-01
6413,東成区,81701,42610,39091,41416,2017-05-01
6414,東淀川区,175716,89315,86401,94868,2017-05-01
6415,西成区,110743,46781,63962,69495,2017-05-01
6416,平野区,195174,102767,92407,90214,2017-05-01
6417,住吉区,153224,81693,71531,72014,2017-05-01
6418,住之江区,121927,63391,58536,57708,2017-05-01
6419,東住吉区,126200,66866,59334,58575,2017-05-01
6420,鶴見区,111508,58170,53338,46945,2017-05-01
6421,城東区,166078,87088,78990,78358,2017-05-01
6422,旭区,91090,47737,43353,44083,2017-05-01
6423,生野区,129800,67346,62454,65186,2017-05-01
6424,阿倍野区,108565,58499,50066,51060,2017-05-01
6425,鶴見区,111568,58243,53325,47087,2017-07-01
6426,生野区,129688,67272,62416,65245,2017-07-01
6427,旭区,91058,47722,43336,44097,2017-07-01
6428,城東区,166122,87115,79007,78390,2017-07-01
6429,阿倍野区,108636,58548,50088,51137,2017-07-01
6430,東成区,81776,42650,39126,41556,2017-07-01
6431,住吉区,153448,81794,71654,72345,2017-07-01
6432,東住吉区,126191,66855,59336,58649,2017-07-01
6433,平野区,195097,102739,92358,90423,2017-07-01
6434,西成区,110551,46712,63839,69410,2017-07-01
6435,住之江区,121808,63323,58485,57773,2017-07-01
6436,東淀川区,175708,89304,86404,94983,2017-07-01
6437,西淀川区,95416,48506,46910,43794,2017-07-01
6438,大阪市,2710672,1400418,1310254,1390179,2017-07-01
6439,淀川区,178815,90132,88683,97743,2017-07-01
6440,北区,128786,66527,62259,77671,2017-07-01
6441,都島区,106177,55054,51123,53446,2017-07-01
6442,此花区,66264,33885,32379,31166,2017-07-01
6443,中央区,96175,51344,44831,61478,2017-07-01
6444,福島区,74126,39167,34959,38959,2017-07-01
6445,港区,81169,41457,39712,40540,2017-07-01
6446,大正区,64437,33000,31437,29566,2017-07-01
6447,天王寺区,78242,41928,36314,39516,2017-07-01
6448,浪速区,72202,35636,36566,49772,2017-07-01
6449,西区,97212,51505,45707,55433,2017-07-01
6450,港区,81145,41432,39713,40543,2017-08-01
6451,浪速区,72313,35707,36606,49890,2017-08-01
6452,天王寺区,78304,41974,36330,39578,2017-08-01
6453,大正区,64431,32977,31454,29600,2017-08-01
6454,西区,97362,51589,45773,55523,2017-08-01
6455,大阪市,2711702,1400978,1310724,1391348,2017-08-01
6456,福島区,74225,39218,35007,39006,2017-08-01
6457,都島区,106311,55109,51202,53575,2017-08-01
6458,北区,129029,66626,62403,77806,2017-08-01
6459,西淀川区,95457,48524,46933,43884,2017-08-01
6460,中央区,96259,51392,44867,61505,2017-08-01
6461,淀川区,178921,90169,88752,97850,2017-08-01
6462,此花区,66328,33932,32396,31239,2017-08-01
6463,東成区,81843,42673,39170,41627,2017-08-01
6464,生野区,129691,67306,62385,65273,2017-08-01
6465,旭区,91047,47723,43324,44092,2017-08-01
6466,城東区,166163,87157,79006,78434,2017-08-01
6467,鶴見区,111598,58275,53323,47078,2017-08-01
6468,阿倍野区,108549,58531,50018,51098,2017-08-01
6469,住之江区,121794,63303,58491,57790,2017-08-01
6470,西成区,110544,46697,63847,69444,2017-08-01
6471,住吉区,153454,81828,71626,72381,2017-08-01
6472,東住吉区,126209,66834,59375,58684,2017-08-01
6473,平野区,195063,102743,92320,90489,2017-08-01
6474,東淀川区,175662,89259,86403,94959,2017-08-01
6475,天王寺区,78342,41990,36352,39586,2017-09-01
6476,大正区,64393,32967,31426,29587,2017-09-01
6477,港区,81101,41434,39667,40528,2017-09-01
6478,西区,97505,51636,45869,55576,2017-09-01
6479,大阪市,2712156,1401264,1310892,1392167,2017-09-01
6480,此花区,66291,33876,32415,31278,2017-09-01
6481,福島区,74324,39286,35038,39053,2017-09-01
6482,都島区,106411,55151,51260,53698,2017-09-01
6483,北区,129317,66752,62565,77958,2017-09-01
6484,浪速区,72286,35670,36616,49878,2017-09-01
6485,中央区,96347,51432,44915,61554,2017-09-01
6486,西淀川区,95521,48555,46966,43979,2017-09-01
6487,旭区,91047,47727,43320,44091,2017-09-01
6488,東淀川区,175717,89287,86430,95067,2017-09-01
6489,東成区,81848,42692,39156,41664,2017-09-01
6490,生野区,129628,67310,62318,65261,2017-09-01
6491,城東区,166215,87185,79030,78465,2017-09-01
6492,鶴見区,111572,58285,53287,47074,2017-09-01
6493,阿倍野区,108585,58532,50053,51108,2017-09-01
6494,住之江区,121676,63244,58432,57772,2017-09-01
6495,住吉区,153376,81768,71608,72362,2017-09-01
6496,東住吉区,126170,66842,59328,58735,2017-09-01
6497,平野区,194996,102732,92264,90537,2017-09-01
6498,西成区,110450,46693,63757,69400,2017-09-01
6499,淀川区,179038,90218,88820,97956,2017-09-01
6500,天王寺区,78372,41995,36377,39604,2017-10-01
6501,大正区,64355,32958,31397,29561,2017-10-01
6502,西区,97667,51748,45919,55644,2017-10-01
6503,中央区,96438,51487,44951,61558,2017-10-01
6504,港区,81065,41438,39627,40505,2017-10-01
6505,福島区,74381,39313,35068,39069,2017-10-01
6506,都島区,106523,55225,51298,53790,2017-10-01
6507,北区,129412,66809,62603,77956,2017-10-01
6508,大阪市,2713157,1401872,1311285,1392900,2017-10-01
6509,浪速区,72350,35697,36653,49925,2017-10-01
6510,此花区,66362,33927,32435,31309,2017-10-01
6511,西淀川区,95518,48561,46957,43985,2017-10-01
6512,東淀川区,175827,89339,86488,95174,2017-10-01
6513,西成区,110410,46663,63747,69401,2017-10-01
6514,淀川区,179136,90288,88848,97988,2017-10-01
6515,平野区,194955,102729,92226,90536,2017-10-01
6516,東住吉区,126161,66841,59320,58747,2017-10-01
6517,住之江区,121785,63318,58467,57851,2017-10-01
6518,阿倍野区,108642,58563,50079,51145,2017-10-01
6519,住吉区,153350,81735,71615,72401,2017-10-01
6520,城東区,166242,87193,79049,78478,2017-10-01
6521,旭区,91069,47720,43349,44128,2017-10-01
6522,生野区,129693,67307,62386,65351,2017-10-01
6523,東成区,81881,42730,39151,41718,2017-10-01
6524,鶴見区,111563,58288,53275,47076,2017-10-01
6525,港区,81049,41438,39611,40535,2017-11-01
6526,浪速区,72608,35904,36704,50202,2017-11-01
6527,天王寺区,78429,42004,36425,39649,2017-11-01
6528,大正区,64357,32953,31404,29592,2017-11-01
6529,西区,97966,51881,46085,55883,2017-11-01
6530,北区,129575,66902,62673,78072,2017-11-01
6531,福島区,74412,39326,35086,39115,2017-11-01
6532,都島区,106504,55200,51304,53838,2017-11-01
6533,大阪市,2714497,1402410,1312087,1395304,2017-11-01
6534,西淀川区,95538,48593,46945,44067,2017-11-01
6535,中央区,96457,51493,44964,61590,2017-11-01
6536,淀川区,179252,90322,88930,98193,2017-11-01
6537,此花区,66381,33938,32443,31391,2017-11-01
6538,東成区,81971,42780,39191,41848,2017-11-01
6539,東淀川区,175877,89329,86548,95318,2017-11-01
6540,平野区,194819,102643,92176,90553,2017-11-01
6541,東住吉区,126225,66860,59365,58858,2017-11-01
6542,住吉区,153388,81728,71660,72504,2017-11-01
6543,住之江区,121687,63281,58406,57854,2017-11-01
6544,西成区,110594,46749,63845,69639,2017-11-01
6545,鶴見区,111544,58266,53278,47080,2017-11-01
6546,城東区,166287,87191,79096,78597,2017-11-01
6547,旭区,91013,47690,43323,44129,2017-11-01
6548,生野区,129836,67373,62463,65572,2017-11-01
6549,阿倍野区,108728,58566,50162,51225,2017-11-01
6550,大阪市,2714710,1402681,1312029,1395593,2017-12-01
6551,天王寺区,78454,42021,36433,39653,2017-12-01
6552,大正区,64340,32943,31397,29600,2017-12-01
6553,港区,81018,41459,39559,40550,2017-12-01
6554,西区,98160,51993,46167,55982,2017-12-01
6555,此花区,66334,33906,32428,31389,2017-12-01
6556,福島区,74504,39374,35130,39148,2017-12-01
6557,都島区,106499,55197,51302,53800,2017-12-01
6558,北区,129691,66961,62730,78120,2017-12-01
6559,浪速区,72563,35873,36690,50137,2017-12-01
6560,中央区,96597,51581,45016,61651,2017-12-01
6561,西淀川区,95594,48627,46967,44105,2017-12-01
6562,旭区,91042,47676,43366,44206,2017-12-01
6563,東淀川区,175918,89351,86567,95322,2017-12-01
6564,東成区,82109,42859,39250,41971,2017-12-01
6565,生野区,129685,67275,62410,65533,2017-12-01
6566,城東区,166243,87203,79040,78593,2017-12-01
6567,鶴見区,111519,58267,53252,47086,2017-12-01
6568,阿倍野区,108670,58557,50113,51176,2017-12-01
6569,住之江区,121659,63288,58371,57858,2017-12-01
6570,住吉区,153330,81745,71585,72445,2017-12-01
6571,東住吉区,126190,66849,59341,58852,2017-12-01
6572,平野区,194777,102609,92168,90613,2017-12-01
6573,西成区,110520,46721,63799,69590,2017-12-01
6574,淀川区,179294,90346,88948,98213,2017-12-01
6575,港区,81089,41495,39594,40609,2018-01-01
6576,天王寺区,78450,42015,36435,39611,2018-01-01
6577,大正区,64332,32956,31376,29611,2018-01-01
6578,西区,98317,52075,46242,56066,2018-01-01
6579,浪速区,72558,35840,36718,50124,2018-01-01
6580,此花区,66241,33877,32364,31354,2018-01-01
6581,福島区,74629,39429,35200,39236,2018-01-01
6582,都島区,106550,55222,51328,53822,2018-01-01
6583,中央区,96729,51675,45054,61707,2018-01-01
6584,西淀川区,95517,48595,46922,44099,2018-01-01
6585,北区,129747,66993,62754,78107,2018-01-01
6586,東淀川区,175882,89339,86543,95301,2018-01-01
6587,東成区,82132,42871,39261,41975,2018-01-01
6588,生野区,129589,67224,62365,65461,2018-01-01
6589,旭区,91016,47662,43354,44202,2018-01-01
6590,城東区,166207,87181,79026,78584,2018-01-01
6591,鶴見区,111464,58217,53247,47067,2018-01-01
6592,阿倍野区,108749,58570,50179,51217,2018-01-01
6593,住之江区,121630,63260,58370,57873,2018-01-01
6594,住吉区,153160,81630,71530,72341,2018-01-01
6595,東住吉区,126192,66827,59365,58878,2018-01-01
6596,淀川区,179456,90418,89038,98263,2018-01-01
6597,大阪市,2714818,1402628,1312190,1395694,2018-01-01
6598,西成区,110436,46678,63758,69552,2018-01-01
6599,平野区,194746,102579,92167,90634,2018-01-01
6600,西区,98431,52152,46279,56146,2018-02-01
6601,大阪市,2714147,1402433,1311714,1395771,2018-02-01
6602,北区,129860,67032,62828,78179,2018-02-01
6603,都島区,106568,55229,51339,53875,2018-02-01
6604,福島区,74750,39495,35255,39295,2018-02-01
6605,此花区,66227,33855,32372,31373,2018-02-01
6606,中央区,96725,51719,45006,61651,2018-02-01
6607,港区,81031,41476,39555,40639,2018-02-01
6608,大正区,64255,32921,31334,29577,2018-02-01
6609,天王寺区,78523,42057,36466,39653,2018-02-01
6610,西淀川区,95540,48610,46930,44124,2018-02-01
6611,淀川区,179546,90480,89066,98291,2018-02-01
6612,浪速区,72367,35741,36626,49988,2018-02-01
6613,東成区,82055,42830,39225,41976,2018-02-01
6614,西成区,110192,46599,63593,69422,2018-02-01
6615,平野区,194659,102527,92132,90643,2018-02-01
6616,東住吉区,126080,66780,59300,58838,2018-02-01
6617,住吉区,153049,81572,71477,72303,2018-02-01
6618,東淀川区,175912,89361,86551,95353,2018-02-01
6619,阿倍野区,108744,58576,50168,51224,2018-02-01
6620,住之江区,121549,63247,58302,57862,2018-02-01
6621,城東区,166183,87177,79006,78590,2018-02-01
6622,旭区,91021,47649,43372,44226,2018-02-01
6623,生野区,129519,67201,62318,65485,2018-02-01
6624,鶴見区,111361,58147,53214,47058,2018-02-01
6625,天王寺区,78551,42083,36468,39663,2018-03-01
6626,西区,98536,52233,46303,56221,2018-03-01
6627,大正区,64162,32886,31276,29572,2018-03-01
6628,港区,81092,41521,39571,40693,2018-03-01
6629,中央区,96757,51730,45027,61614,2018-03-01
6630,阿倍野区,108782,58612,50170,51247,2018-03-01
6631,福島区,74820,39517,35303,39366,2018-03-01
6632,都島区,106565,55219,51346,53917,2018-03-01
6633,北区,129941,67083,62858,78211,2018-03-01
6634,大阪市,2713808,1402300,1311508,1396125,2018-03-01
6635,浪速区,72358,35726,36632,49939,2018-03-01
6636,此花区,66168,33813,32355,31387,2018-03-01
6637,西淀川区,95489,48605,46884,44143,2018-03-01
6638,平野区,194538,102438,92100,90640,2018-03-01
6639,東淀川区,175680,89206,86474,95281,2018-03-01
6640,東成区,82216,42916,39300,42094,2018-03-01
6641,生野区,129424,67165,62259,65479,2018-03-01
6642,旭区,90960,47636,43324,44198,2018-03-01
6643,城東区,166373,87253,79120,78741,2018-03-01
6644,鶴見区,111302,58123,53179,47025,2018-03-01
6645,住之江区,121510,63211,58299,57878,2018-03-01
6646,住吉区,152923,81530,71393,72298,2018-03-01
6647,東住吉区,126023,66763,59260,58842,2018-03-01
6648,西成区,110009,46504,63505,69339,2018-03-01
6649,淀川区,179629,90527,89102,98337,2018-03-01
6650,天王寺区,78615,42136,36479,39709,2018-04-01
6651,西区,99001,52503,46498,56609,2018-04-01
6652,大正区,64009,32833,31176,29584,2018-04-01
6653,港区,81238,41602,39636,40888,2018-04-01
6654,中央区,97161,51995,45166,61954,2018-04-01
6655,東淀川区,175859,89414,86445,95667,2018-04-01
6656,福島区,74902,39562,35340,39565,2018-04-01
6657,都島区,106568,55300,51268,54066,2018-04-01
6658,北区,131241,67784,63457,79109,2018-04-01
6659,大阪市,2716989,1404716,1312273,1401429,2018-04-01
6660,浪速区,72415,35726,36689,50082,2018-04-01
6661,此花区,66103,33829,32274,31424,2018-04-01
6662,西淀川区,95539,48620,46919,44347,2018-04-01
6663,住之江区,121486,63205,58281,58024,2018-04-01
6664,住吉区,152970,81589,71381,72507,2018-04-01
6665,東成区,82560,43159,39401,42454,2018-04-01
6666,生野区,129467,67235,62232,65657,2018-04-01
6667,旭区,91004,47687,43317,44288,2018-04-01
6668,城東区,166498,87321,79177,78987,2018-04-01
6669,鶴見区,111059,58006,53053,47057,2018-04-01
6670,阿倍野区,108900,58732,50168,51384,2018-04-01
6671,西成区,109898,46493,63405,69368,2018-04-01
6672,東住吉区,125972,66788,59184,58983,2018-04-01
6673,平野区,194383,102386,91997,90797,2018-04-01
6674,淀川区,180141,90811,89330,98919,2018-04-01
6675,大正区,63943,32812,31131,29641,2018-05-01
6676,天王寺区,78836,42252,36584,39900,2018-05-01
6677,東淀川区,176149,89578,86571,96124,2018-05-01
6678,港区,81357,41673,39684,41050,2018-05-01
6679,浪速区,72869,35951,36918,50564,2018-05-01
6680,西区,99544,52788,46756,57066,2018-05-01
6681,大阪市,2721728,1407112,1314616,1407997,2018-05-01
6682,此花区,66143,33833,32310,31523,2018-05-01
6683,福島区,75006,39585,35421,39735,2018-05-01
6684,都島区,106638,55324,51314,54224,2018-05-01
6685,北区,132109,68207,63902,79747,2018-05-01
6686,中央区,97376,52093,45283,62250,2018-05-01
6687,西淀川区,95598,48648,46950,44473,2018-05-01
6688,旭区,91098,47732,43366,44455,2018-05-01
6689,東成区,82712,43238,39474,42676,2018-05-01
6690,生野区,129868,67394,62474,66164,2018-05-01
6691,城東区,166454,87338,79116,79123,2018-05-01
6692,鶴見区,111042,58003,53039,47127,2018-05-01
6693,阿倍野区,109133,58862,50271,51672,2018-05-01
6694,住之江区,121496,63216,58280,58140,2018-05-01
6695,住吉区,153014,81597,71417,72734,2018-05-01
6696,東住吉区,126042,66859,59183,59197,2018-05-01
6697,平野区,194331,102399,91932,91026,2018-05-01
6698,西成区,110165,46629,63536,69740,2018-05-01
6699,淀川区,180805,91101,89704,99646,2018-05-01
6700,天王寺区,78754,42209,36545,39871,2018-06-01
6701,浪速区,72884,35984,36900,50565,2018-06-01
6702,大正区,63888,32784,31104,29655,2018-06-01
6703,都島区,106662,55338,51324,54275,2018-06-01
6704,西区,99709,52876,46833,57244,2018-06-01
6705,中央区,97570,52160,45410,62407,2018-06-01
6706,福島区,75178,39653,35525,39877,2018-06-01
6707,淀川区,180925,91144,89781,99847,2018-06-01
6708,港区,81306,41648,39658,41074,2018-06-01
6709,東淀川区,176050,89527,86523,96178,2018-06-01
6710,西淀川区,95589,48657,46932,44552,2018-06-01
6711,生野区,129745,67336,62409,66161,2018-06-01
6712,旭区,91114,47764,43350,44471,2018-06-01
6713,城東区,166570,87413,79157,79223,2018-06-01
6714,鶴見区,111006,57950,53056,47168,2018-06-01
6715,阿倍野区,109110,58879,50231,51702,2018-06-01
6716,住之江区,121420,63204,58216,58195,2018-06-01
6717,住吉区,153119,81626,71493,72923,2018-06-01
6718,東住吉区,126007,66842,59165,59271,2018-06-01
6719,平野区,194324,102407,91917,91124,2018-06-01
6720,西成区,110114,46604,63510,69788,2018-06-01
6721,北区,132289,68304,63985,79898,2018-06-01
6722,東成区,82688,43270,39418,42727,2018-06-01
6723,大阪市,2722098,1407370,1314728,1409717,2018-06-01
6724,此花区,66077,33791,32286,31521,2018-06-01
6725,平野区,194222,102378,91844,91132,2018-07-01
6726,大阪市,2723100,1407981,1315119,1410573,2018-07-01
6727,北区,132555,68455,64100,80024,2018-07-01
6728,都島区,106685,55365,51320,54318,2018-07-01
6729,福島区,75233,39678,35555,39886,2018-07-01
6730,此花区,66031,33762,32269,31509,2018-07-01
6731,中央区,97710,52224,45486,62486,2018-07-01
6732,港区,81272,41626,39646,41060,2018-07-01
6733,大正区,63804,32727,31077,29654,2018-07-01
6734,天王寺区,78815,42237,36578,39877,2018-07-01
6735,浪速区,72881,35979,36902,50551,2018-07-01
6736,西淀川区,95707,48694,47013,44637,2018-07-01
6737,西区,100022,53057,46965,57456,2018-07-01
6738,東淀川区,176139,89583,86556,96249,2018-07-01
6739,淀川区,180966,91177,89789,99836,2018-07-01
6740,住吉区,153233,81743,71490,73052,2018-07-01
6741,住之江区,121429,63193,58236,58245,2018-07-01
6742,西成区,110088,46585,63503,69792,2018-07-01
6743,阿倍野区,109090,58873,50217,51670,2018-07-01
6744,東住吉区,125903,66811,59092,59241,2018-07-01
6745,城東区,166676,87486,79190,79294,2018-07-01
6746,旭区,91148,47783,43365,44479,2018-07-01
6747,生野区,129689,67272,62417,66163,2018-07-01
6748,東成区,82718,43284,39434,42744,2018-07-01
6749,鶴見区,111084,58009,53075,47218,2018-07-01
6750,浪速区,72952,36043,36909,50600,2018-08-01
6751,天王寺区,78936,42303,36633,39957,2018-08-01
6752,大正区,63779,32715,31064,29650,2018-08-01
6753,港区,81206,41599,39607,41048,2018-08-01
6754,西区,100233,53198,47035,57669,2018-08-01
6755,福島区,75337,39732,35605,39947,2018-08-01
6756,此花区,65988,33753,32235,31504,2018-08-01
6757,都島区,106797,55396,51401,54405,2018-08-01
6758,北区,132761,68569,64192,80208,2018-08-01
6759,大阪市,2724007,1408589,1315418,1411998,2018-08-01
6760,中央区,97865,52292,45573,62617,2018-08-01
6761,西淀川区,95722,48711,47011,44688,2018-08-01
6762,阿倍野区,109117,58873,50244,51635,2018-08-01
6763,東淀川区,176055,89557,86498,96239,2018-08-01
6764,淀川区,180999,91205,89794,99938,2018-08-01
6765,平野区,194202,102369,91833,91240,2018-08-01
6766,東住吉区,125881,66804,59077,59258,2018-08-01
6767,住吉区,153312,81829,71483,73120,2018-08-01
6768,住之江区,121425,63173,58252,58325,2018-08-01
6769,西成区,110028,46546,63482,69831,2018-08-01
6770,鶴見区,111172,58064,53108,47282,2018-08-01
6771,城東区,166798,87565,79233,79390,2018-08-01
6772,旭区,91106,47776,43330,44490,2018-08-01
6773,生野区,129591,67227,62364,66147,2018-08-01
6774,東成区,82745,43290,39455,42810,2018-08-01
6775,浪速区,72966,36050,36916,50628,2018-09-01
6776,天王寺区,79019,42335,36684,39987,2018-09-01
6777,大正区,63743,32694,31049,29671,2018-09-01
6778,大阪市,2724355,1408816,1315539,1412872,2018-09-01
6779,西区,100359,53295,47064,57788,2018-09-01
6780,此花区,65986,33763,32223,31542,2018-09-01
6781,西淀川区,95711,48711,47000,44718,2018-09-01
6782,福島区,75510,39797,35713,40071,2018-09-01
6783,都島区,106828,55404,51424,54429,2018-09-01
6784,北区,133011,68666,64345,80340,2018-09-01
6785,中央区,97931,52278,45653,62660,2018-09-01
6786,淀川区,180893,91119,89774,99819,2018-09-01
6787,港区,81106,41561,39545,41009,2018-09-01
6788,東成区,82909,43404,39505,42987,2018-09-01
6789,西成区,109885,46494,63391,69782,2018-09-01
6790,平野区,194044,102275,91769,91223,2018-09-01
6791,東住吉区,125943,66868,59075,59332,2018-09-01
6792,住吉区,153385,81908,71477,73207,2018-09-01
6793,住之江区,121420,63175,58245,58352,2018-09-01
6794,東淀川区,176021,89539,86482,96286,2018-09-01
6795,鶴見区,111244,58104,53140,47344,2018-09-01
6796,城東区,166777,87541,79236,79389,2018-09-01
6797,旭区,91093,47777,43316,44536,2018-09-01
6798,生野区,129460,67173,62287,66138,2018-09-01
6799,阿倍野区,109111,58885,50226,51634,2018-09-01
6800,浪速区,72991,36082,36909,50595,2018-10-01
6801,天王寺区,79177,42414,36763,40066,2018-10-01
6802,大正区,63741,32685,31056,29674,2018-10-01
6803,港区,81076,41562,39514,40981,2018-10-01
6804,西区,100437,53355,47082,57766,2018-10-01
6805,此花区,65914,33713,32201,31505,2018-10-01
6806,福島区,75896,39988,35908,40201,2018-10-01
6807,都島区,106858,55429,51429,54424,2018-10-01
6808,北区,133123,68713,64410,80383,2018-10-01
6809,西淀川区,95749,48734,47015,44732,2018-10-01
6810,中央区,98094,52348,45746,62681,2018-10-01
6811,淀川区,180998,91137,89861,99874,2018-10-01
6812,大阪市,2725006,1409264,1315742,1412983,2018-10-01
6813,東成区,82857,43404,39453,42949,2018-10-01
6814,西成区,109764,46458,63306,69711,2018-10-01
6815,平野区,193925,102261,91664,91178,2018-10-01
6816,東住吉区,125907,66856,59051,59333,2018-10-01
6817,住吉区,153361,81870,71491,73184,2018-10-01
6818,住之江区,121364,63146,58218,58323,2018-10-01
6819,東淀川区,176031,89557,86474,96308,2018-10-01
6820,鶴見区,111268,58123,53145,47356,2018-10-01
6821,城東区,166852,87557,79295,79448,2018-10-01
6822,旭区,91072,47822,43250,44533,2018-10-01
6823,生野区,129379,67130,62249,66128,2018-10-01
6824,阿倍野区,109172,58920,50252,51650,2018-10-01
6825,浪速区,73234,36210,37024,50882,2018-11-01
6826,天王寺区,79273,42472,36801,40142,2018-11-01
6827,大正区,63654,32636,31018,29658,2018-11-01
6828,港区,81073,41576,39497,41078,2018-11-01
6829,西区,100625,53447,47178,57974,2018-11-01
6830,此花区,65897,33714,32183,31532,2018-11-01
6831,福島区,76006,40025,35981,40293,2018-11-01
6832,都島区,106861,55421,51440,54483,2018-11-01
6833,北区,133462,68874,64588,80615,2018-11-01
6834,西淀川区,95865,48809,47056,44852,2018-11-01
6835,中央区,98265,52441,45824,62889,2018-11-01
6836,大阪市,2726579,1410126,1316453,1415735,2018-11-01
6837,東淀川区,176022,89546,86476,96382,2018-11-01
6838,東成区,82929,43464,39465,43046,2018-11-01
6839,生野区,129646,67284,62362,66411,2018-11-01
6840,旭区,91029,47799,43230,44581,2018-11-01
6841,城東区,166914,87610,79304,79567,2018-11-01
6842,鶴見区,111370,58191,53179,47425,2018-11-01
6843,阿倍野区,109249,58940,50309,51731,2018-11-01
6844,住之江区,121307,63124,58183,58354,2018-11-01
6845,住吉区,153402,81881,71521,73314,2018-11-01
6846,東住吉区,125836,66836,59000,59333,2018-11-01
6847,平野区,193848,102192,91656,91297,2018-11-01
6848,西成区,109836,46494,63342,69893,2018-11-01
6849,淀川区,180976,91140,89836,100003,2018-11-01
6850,天王寺区,79326,42519,36807,40195,2018-12-01
6851,大正区,63574,32598,30976,29643,2018-12-01
6852,港区,81017,41526,39491,41078,2018-12-01
6853,西区,100757,53540,47217,58022,2018-12-01
6854,浪速区,73142,36142,37000,50801,2018-12-01
6855,此花区,65928,33741,32187,31555,2018-12-01
6856,福島区,76114,40062,36052,40364,2018-12-01
6857,都島区,106840,55404,51436,54479,2018-12-01
6858,北区,133636,68980,64656,80664,2018-12-01
6859,中央区,98407,52513,45894,62915,2018-12-01
6860,西淀川区,95825,48802,47023,44841,2018-12-01
6861,西成区,109724,46443,63281,69817,2018-12-01
6862,東淀川区,176122,89589,86533,96438,2018-12-01
6863,東成区,83035,43478,39557,43132,2018-12-01
6864,生野区,129638,67294,62344,66429,2018-12-01
6865,旭区,90983,47779,43204,44556,2018-12-01
6866,城東区,166937,87632,79305,79612,2018-12-01
6867,鶴見区,111480,58257,53223,47480,2018-12-01
6868,阿倍野区,109221,58924,50297,51711,2018-12-01
6869,住之江区,121253,63113,58140,58353,2018-12-01
6870,住吉区,153439,81927,71512,73321,2018-12-01
6871,東住吉区,125859,66857,59002,59374,2018-12-01
6872,平野区,193892,102228,91664,91416,2018-12-01
6873,淀川区,180987,91142,89845,100006,2018-12-01
6874,大阪市,2727136,1410490,1316646,1416202,2018-12-01
